region_id,"Couple family with no children, families","Couple family with no children, persons",Persons per family,"Couple families with children under 15, families","Couple families with children under 15, persons",Children per family,"Couple family with no children under 15, families","Couple family with no children under 15, persons",Children per family,"Couple families, families","Couple families, persons",Average family size,"Single-parent family with children under 15, families","Single-parent family with children under 15, persons",Children per family,"Single-parent family with no children under 15, families","Single-parent family with no children under 15, persons",Children per family,"Single-parent families, families","Single-parent families, persons",Average family size,"Other families, families","Other families, persons",Average family size
POA2000,2492,4960,1.990369181,485,1637,1.375257732,228,718,2.149122807,713,2355,3.302945302,132,326,1.46969697,246,536,1.178861789,378,862,2.28042328,409,892,2.180929095
POA2006,3,3,1,0,12,#DIV/0!,4,9,1.25,4,21,5.25,0,0,#DIV/0!,0,0,#DIV/0!,0,0,#DIV/0!,0,0,#DIV/0!
POA2007,693,1390,2.005772006,171,579,1.385964912,62,197,2.177419355,233,776,3.330472103,51,136,1.666666667,66,136,1.060606061,117,272,2.324786325,97,209,2.154639175
POA2008,697,1369,1.964131994,152,517,1.401315789,35,118,2.371428571,187,635,3.395721925,37,93,1.513513514,63,142,1.253968254,100,235,2.35,84,167,1.988095238
POA2009,1764,3454,1.958049887,509,1752,1.442043222,172,524,2.046511628,681,2276,3.342143906,142,374,1.633802817,172,375,1.180232558,314,749,2.385350318,111,231,2.081081081
POA2010,3516,6845,1.946814562,590,2075,1.516949153,182,564,2.098901099,772,2639,3.418393782,122,299,1.450819672,214,423,0.976635514,336,722,2.148809524,185,394,2.12972973
POA2011,2343,4509,1.924455826,333,1119,1.36036036,122,374,2.06557377,455,1493,3.281318681,131,326,1.488549618,171,349,1.040935673,302,675,2.235099338,88,185,2.102272727
POA2015,1222,2393,1.958265139,476,1650,1.466386555,109,354,2.247706422,585,2004,3.425641026,103,268,1.601941748,110,245,1.227272727,213,513,2.408450704,62,135,2.177419355
POA2016,1394,2746,1.969870875,389,1353,1.4781491,111,371,2.342342342,500,1724,3.448,106,259,1.443396226,211,457,1.165876777,317,716,2.258675079,104,218,2.096153846
POA2017,1632,3229,1.978553922,451,1556,1.450110865,149,493,2.308724832,600,2049,3.415,223,616,1.762331839,289,618,1.138408304,512,1234,2.41015625,194,400,2.06185567
POA2018,1321,2648,2.004542014,1243,4848,1.900241352,639,2187,2.422535211,1882,7035,3.738044633,273,761,1.787545788,383,875,1.2845953,656,1636,2.493902439,120,248,2.066666667
POA2019,659,1322,2.006069803,873,3481,1.987399771,347,1184,2.412103746,1220,4665,3.823770492,181,489,1.701657459,214,505,1.359813084,395,994,2.516455696,42,86,2.047619048
POA2020,1013,2056,2.029615005,774,3043,1.931524548,460,1593,2.463043478,1234,4636,3.756888169,168,474,1.821428571,245,561,1.289795918,413,1035,2.506053269,104,229,2.201923077
POA2021,1616,3143,1.944925743,814,2966,1.643734644,266,867,2.259398496,1080,3833,3.549074074,151,347,1.298013245,179,374,1.089385475,330,721,2.184848485,81,168,2.074074074
POA2022,1204,2377,1.974252492,772,2962,1.836787565,265,868,2.275471698,1037,3830,3.693346191,134,363,1.708955224,224,488,1.178571429,358,851,2.377094972,86,178,2.069767442
POA2023,1005,1969,1.95920398,802,3264,2.069825436,380,1292,2.4,1182,4556,3.854483926,110,285,1.590909091,169,385,1.278106509,279,670,2.401433692,55,118,2.145454545
POA2024,1008,1963,1.947420635,892,3474,1.894618834,318,1071,2.367924528,1210,4545,3.756198347,139,353,1.539568345,193,412,1.134715026,332,765,2.304216867,35,68,1.942857143
POA2025,829,1614,1.946924005,485,1828,1.769072165,186,604,2.247311828,671,2432,3.624441133,88,218,1.477272727,142,308,1.169014085,230,526,2.286956522,44,90,2.045454545
POA2026,3215,6281,1.953654743,1931,7258,1.758674262,587,1948,2.318568995,2518,9206,3.656076251,356,852,1.393258427,388,851,1.193298969,744,1703,2.288978495,165,335,2.03030303
POA2027,1012,1965,1.941699605,329,1209,1.674772036,137,431,2.145985401,466,1640,3.519313305,81,201,1.481481481,99,205,1.070707071,180,406,2.255555556,51,104,2.039215686
POA2028,562,1091,1.941281139,246,943,1.833333333,95,314,2.305263158,341,1257,3.686217009,51,127,1.490196078,101,209,1.069306931,152,336,2.210526316,44,89,2.022727273
POA2029,1023,2014,1.968719453,766,2990,1.903394256,286,952,2.328671329,1052,3942,3.747148289,142,338,1.38028169,169,370,1.189349112,311,708,2.276527331,61,127,2.081967213
POA2030,1184,2335,1.972128378,1294,5377,2.155332303,688,2326,2.380813953,1982,7703,3.886478305,166,466,1.807228916,220,492,1.236363636,386,958,2.481865285,59,131,2.220338983
POA2031,3249,6386,1.965527855,2493,9394,1.768150822,812,2700,2.325123153,3305,12094,3.659304085,437,1044,1.389016018,562,1220,1.170818505,999,2264,2.266266266,256,531,2.07421875
POA2032,1207,2456,2.034797017,948,3649,1.849156118,516,1748,2.387596899,1464,5397,3.68647541,180,480,1.666666667,371,855,1.30458221,551,1335,2.422867514,184,389,2.114130435
POA2033,1023,2036,1.990224829,626,2431,1.883386581,288,974,2.381944444,914,3405,3.725382932,117,308,1.632478632,183,412,1.25136612,300,720,2.4,118,255,2.161016949
POA2034,1990,3908,1.963819095,1370,5143,1.754014599,466,1571,2.371244635,1836,6714,3.656862745,258,631,1.445736434,323,690,1.13622291,581,1321,2.273666093,128,264,2.0625
POA2035,2911,5802,1.993129509,2523,9890,1.919936583,1309,4493,2.432391138,3832,14383,3.753392484,536,1456,1.71641791,880,2012,1.286363636,1416,3468,2.449152542,301,666,2.212624585
POA2036,1984,4014,2.023185484,2107,8507,2.037494067,1281,4417,2.448087432,3388,12924,3.814639906,551,1597,1.898366606,703,1591,1.263157895,1254,3188,2.542264753,138,297,2.152173913
POA2037,1529,2991,1.95618051,600,2186,1.643333333,241,799,2.315352697,841,2985,3.549346017,227,672,1.960352423,304,690,1.269736842,531,1362,2.564971751,110,232,2.109090909
POA2038,950,1863,1.961052632,709,2630,1.709449929,165,531,2.218181818,874,3161,3.616704805,119,291,1.445378151,143,311,1.174825175,262,602,2.297709924,58,120,2.068965517
POA2039,1020,1987,1.948039216,699,2520,1.605150215,162,529,2.265432099,861,3049,3.541231127,96,236,1.458333333,131,273,1.083969466,227,509,2.242290749,46,90,1.956521739
POA2040,2032,3996,1.966535433,1890,6959,1.682010582,505,1637,2.241584158,2395,8596,3.58914405,326,842,1.582822086,438,949,1.166666667,764,1791,2.344240838,164,338,2.06097561
POA2041,1824,3556,1.949561404,1169,4347,1.718562874,380,1212,2.189473684,1549,5559,3.588766946,176,438,1.488636364,258,542,1.100775194,434,980,2.258064516,73,153,2.095890411
POA2042,2067,4058,1.963231737,915,3291,1.596721311,234,775,2.311965812,1149,4066,3.53872933,175,430,1.457142857,255,560,1.196078431,430,990,2.302325581,147,294,2
POA2043,1048,2063,1.96851145,416,1451,1.487980769,79,255,2.227848101,495,1706,3.446464646,83,207,1.493975904,94,200,1.127659574,177,407,2.299435028,49,99,2.020408163
POA2044,755,1497,1.982781457,485,1826,1.764948454,204,717,2.514705882,689,2543,3.690856313,129,350,1.713178295,172,388,1.255813953,301,738,2.451827243,61,134,2.196721311
POA2045,545,1086,1.99266055,579,2398,2.141623489,372,1297,2.48655914,951,3695,3.885383807,72,184,1.555555556,159,362,1.27672956,231,546,2.363636364,34,68,2
POA2046,2712,5362,1.977138643,2197,8383,1.815657715,1068,3667,2.433520599,3265,12050,3.690658499,369,981,1.658536585,566,1270,1.243816254,935,2251,2.407486631,135,277,2.051851852
POA2047,1352,2657,1.965236686,865,3315,1.832369942,344,1131,2.287790698,1209,4446,3.677419355,135,345,1.555555556,192,429,1.234375,327,774,2.366972477,68,134,1.970588235
POA2048,833,1629,1.955582233,534,2016,1.775280899,176,573,2.255681818,710,2589,3.646478873,91,223,1.450549451,144,309,1.145833333,235,532,2.263829787,59,123,2.084745763
POA2049,1021,2002,1.960822723,728,2734,1.755494505,272,932,2.426470588,1000,3666,3.666,162,432,1.666666667,197,441,1.23857868,359,873,2.431754875,68,140,2.058823529
POA2050,995,1944,1.953768844,300,1052,1.506666667,58,184,2.172413793,358,1236,3.452513966,58,151,1.603448276,59,121,1.050847458,117,272,2.324786325,70,149,2.128571429
POA2052,5,14,2.8,7,15,0.142857143,0,0,#DIV/0!,7,15,2.142857143,0,0,#DIV/0!,0,0,#DIV/0!,0,0,#DIV/0!,0,0,#DIV/0!
POA2060,1825,3564,1.952876712,576,2060,1.576388889,234,720,2.076923077,810,2780,3.432098765,107,259,1.420560748,168,355,1.113095238,275,614,2.232727273,84,175,2.083333333
POA2061,945,1827,1.933333333,210,728,1.466666667,103,319,2.097087379,313,1047,3.345047923,30,70,1.333333333,71,147,1.070422535,101,217,2.148514851,34,68,2
POA2062,826,1619,1.960048426,516,1903,1.687984496,150,509,2.393333333,666,2412,3.621621622,110,271,1.463636364,121,260,1.148760331,231,531,2.298701299,31,68,2.193548387
POA2063,489,967,1.977505112,612,2564,2.189542484,329,1118,2.398176292,941,3682,3.912858661,76,213,1.802631579,90,214,1.377777778,166,427,2.572289157,17,35,2.058823529
POA2064,888,1760,1.981981982,830,3090,1.722891566,236,789,2.343220339,1066,3879,3.638836773,126,330,1.619047619,172,383,1.226744186,298,713,2.39261745,63,133,2.111111111
POA2065,3690,7234,1.960433604,1969,7183,1.648044693,644,2143,2.327639752,2613,9326,3.569077688,261,634,1.429118774,460,982,1.134782609,721,1616,2.241331484,238,492,2.067226891
POA2066,2598,5143,1.979599692,2722,10700,1.930933137,1033,3549,2.435624395,3755,14249,3.794673768,333,854,1.564564565,502,1081,1.153386454,835,1935,2.317365269,158,323,2.044303797
POA2067,2188,4358,1.991773309,1908,7159,1.752096436,870,2961,2.403448276,2778,10120,3.642908567,285,764,1.680701754,525,1216,1.316190476,810,1980,2.444444444,204,441,2.161764706
POA2068,1302,2582,1.983102919,1716,6885,2.012237762,684,2348,2.432748538,2400,9233,3.847083333,189,484,1.560846561,336,753,1.241071429,525,1237,2.356190476,76,162,2.131578947
POA2069,1084,2142,1.97601476,1401,5766,2.115631692,721,2454,2.403606103,2122,8220,3.873704053,126,371,1.944444444,223,529,1.372197309,349,900,2.578796562,57,117,2.052631579
POA2070,929,1831,1.970936491,1288,5336,2.142857143,657,2265,2.447488584,1945,7601,3.907969152,120,349,1.908333333,227,542,1.387665198,347,891,2.567723343,47,93,1.978723404
POA2071,1012,2005,1.981225296,1126,4649,2.128774423,740,2536,2.427027027,1866,7185,3.850482315,155,430,1.774193548,225,536,1.382222222,380,966,2.542105263,42,106,2.523809524
POA2072,598,1185,1.981605351,595,2395,2.025210084,382,1300,2.403141361,977,3695,3.78198567,93,247,1.655913978,129,293,1.271317829,222,540,2.432432432,32,69,2.15625
POA2073,1262,2491,1.97385103,1673,6901,2.124925284,966,3301,2.417184265,2639,10202,3.86585828,154,427,1.772727273,275,643,1.338181818,429,1070,2.494172494,42,88,2.095238095
POA2074,1998,3935,1.969469469,2005,8289,2.134164589,1126,3859,2.427175844,3131,12148,3.879910572,192,564,1.9375,355,813,1.290140845,547,1377,2.517367459,56,117,2.089285714
POA2075,1846,3648,1.97616468,1791,7437,2.152428811,1185,4067,2.432067511,2976,11504,3.865591398,176,530,2.011363636,288,670,1.326388889,464,1200,2.586206897,43,91,2.11627907
POA2076,2083,4135,1.985117619,2258,9319,2.127103632,1254,4349,2.468102073,3512,13668,3.891799544,251,717,1.856573705,443,1012,1.284424379,694,1729,2.491354467,64,140,2.1875
POA2077,3339,6649,1.991314765,3421,13094,1.827535808,1392,4709,2.382902299,4813,17803,3.69894037,540,1404,1.6,877,1992,1.271379704,1417,3396,2.396612562,158,336,2.126582278
POA2079,568,1135,1.998239437,750,3056,2.074666667,433,1545,2.56812933,1183,4601,3.889264582,88,227,1.579545455,141,322,1.283687943,229,549,2.397379913,21,51,2.428571429
POA2080,153,304,1.986928105,157,627,1.993630573,86,297,2.453488372,243,924,3.802469136,21,72,2.428571429,34,71,1.088235294,55,143,2.6,5,12,2.4
POA2081,428,844,1.971962617,587,2396,2.081771721,265,917,2.460377358,852,3313,3.888497653,74,219,1.959459459,76,177,1.328947368,150,396,2.64,10,24,2.4
POA2082,543,1061,1.953959484,607,2452,2.039538715,292,989,2.386986301,899,3441,3.827586207,85,248,1.917647059,97,230,1.371134021,182,478,2.626373626,10,19,1.9
POA2083,191,377,1.97382199,127,511,2.023622047,57,188,2.298245614,184,699,3.798913043,27,73,1.703703704,26,58,1.230769231,53,131,2.471698113,3,6,2
POA2084,317,626,1.974763407,344,1441,2.188953488,220,780,2.545454545,564,2221,3.937943262,36,108,2,39,96,1.461538462,75,204,2.72,6,12,2
POA2085,1027,2047,1.993184031,1083,4531,2.183748846,560,1919,2.426785714,1643,6450,3.925745587,99,271,1.737373737,182,421,1.313186813,281,692,2.462633452,28,63,2.25
POA2086,1118,2227,1.991949911,1506,6172,2.098273572,714,2457,2.441176471,2220,8629,3.886936937,147,432,1.93877551,247,552,1.234817814,394,984,2.497461929,24,51,2.125
POA2087,1062,2119,1.995291902,1348,5538,2.108308605,579,1955,2.376511226,1927,7493,3.888427608,160,440,1.75,232,526,1.267241379,392,966,2.464285714,31,66,2.129032258
POA2088,2931,5752,1.962470147,2362,9305,1.939458086,878,2932,2.339407745,3240,12237,3.776851852,340,874,1.570588235,429,956,1.228438228,769,1830,2.379713914,103,211,2.048543689
POA2089,1619,3165,1.954910439,584,2091,1.580479452,202,652,2.227722772,786,2743,3.489821883,112,258,1.303571429,144,307,1.131944444,256,565,2.20703125,82,165,2.012195122
POA2090,1646,3206,1.947752126,921,3355,1.642779587,282,914,2.241134752,1203,4269,3.548628429,113,287,1.539823009,199,405,1.035175879,312,692,2.217948718,83,160,1.927710843
POA2092,502,994,1.980079681,791,3266,2.128950695,320,1074,2.35625,1111,4340,3.906390639,80,232,1.9,123,272,1.211382114,203,504,2.482758621,18,43,2.388888889
POA2093,1932,3808,1.971014493,2362,9371,1.967400508,799,2706,2.386733417,3161,12077,3.820626384,347,917,1.642651297,386,853,1.20984456,733,1770,2.41473397,68,148,2.176470588
POA2094,710,1377,1.93943662,489,1836,1.754601227,137,459,2.350364964,626,2295,3.666134185,69,176,1.550724638,104,230,1.211538462,173,406,2.346820809,19,39,2.052631579
POA2095,2041,3964,1.942185203,951,3526,1.70767613,269,858,2.189591078,1220,4384,3.593442623,158,409,1.588607595,190,403,1.121052632,348,812,2.333333333,65,130,2
POA2096,1567,3071,1.959795788,1253,4826,1.851556265,394,1363,2.459390863,1647,6189,3.757741348,196,511,1.607142857,229,495,1.161572052,425,1006,2.367058824,65,139,2.138461538
POA2097,1405,2773,1.97366548,1434,5789,2.036959554,598,2045,2.419732441,2032,7834,3.855314961,220,608,1.763636364,270,601,1.225925926,490,1209,2.467346939,52,117,2.25
POA2099,3702,7355,1.986763911,3298,12862,1.899939357,1309,4512,2.446906035,4607,17374,3.771217712,631,1665,1.63866878,801,1761,1.198501873,1432,3426,2.392458101,189,382,2.021164021
POA2100,1654,3288,1.987908102,1972,7885,1.998478702,903,3159,2.49833887,2875,11044,3.841391304,266,738,1.77443609,387,885,1.286821705,653,1623,2.485451761,67,152,2.268656716
POA2101,1857,3691,1.987614432,1551,6130,1.952288846,646,2204,2.411764706,2197,8334,3.793354574,244,654,1.680327869,326,733,1.248466258,570,1387,2.433333333,50,101,2.02
POA2102,512,1008,1.96875,684,2767,2.045321637,244,835,2.422131148,928,3602,3.881465517,104,281,1.701923077,133,296,1.22556391,237,577,2.434599156,15,36,2.4
POA2103,1058,2098,1.982986767,857,3455,2.031505251,445,1537,2.453932584,1302,4992,3.834101382,145,382,1.634482759,229,495,1.161572052,374,877,2.344919786,23,48,2.086956522
POA2104,386,762,1.974093264,203,851,2.192118227,162,544,2.358024691,365,1395,3.821917808,19,52,1.736842105,50,113,1.26,69,165,2.391304348,9,18,2
POA2105,210,401,1.90952381,163,643,1.944785276,112,354,2.160714286,275,997,3.625454545,30,76,1.533333333,27,65,1.407407407,57,141,2.473684211,4,8,2
POA2106,942,1843,1.956475584,813,3245,1.991389914,395,1301,2.293670886,1208,4546,3.763245033,127,353,1.779527559,199,424,1.130653266,326,777,2.383435583,30,65,2.166666667
POA2107,1479,2919,1.973630832,1399,5662,2.047176555,683,2248,2.29136164,2082,7910,3.799231508,197,540,1.741116751,269,617,1.293680297,466,1157,2.482832618,26,47,1.807692308
POA2108,277,542,1.9566787,106,412,1.886792453,70,225,2.214285714,176,637,3.619318182,20,59,1.95,35,76,1.171428571,55,135,2.454545455,3,6,2
POA2109,54,106,1.962962963,37,143,1.864864865,7,31,3.428571429,44,174,3.954545455,0,0,#DIV/0!,4,11,1.75,4,11,2.75,0,0,#DIV/0!
POA2110,801,1578,1.970037453,813,3394,2.174661747,448,1547,2.453125,1261,4941,3.918318795,97,254,1.618556701,159,355,1.232704403,256,609,2.37890625,26,55,2.115384615
POA2111,1310,2581,1.970229008,1206,4781,1.964344942,549,1876,2.41712204,1755,6657,3.793162393,185,461,1.491891892,264,604,1.287878788,449,1065,2.371937639,65,131,2.015384615
POA2112,2425,4859,2.00371134,2503,9960,1.97922493,1365,4723,2.46007326,3868,14683,3.796018614,390,1081,1.771794872,666,1517,1.277777778,1056,2598,2.460227273,125,267,2.136
POA2113,1599,3187,1.9931207,1431,5570,1.892382949,708,2481,2.504237288,2139,8051,3.763908368,197,524,1.659898477,404,943,1.334158416,601,1467,2.44093178,102,209,2.049019608
POA2114,2217,4448,2.00631484,1894,7230,1.817317846,910,3184,2.498901099,2804,10414,3.713980029,266,722,1.714285714,436,988,1.266055046,702,1710,2.435897436,143,304,2.125874126
POA2115,713,1442,2.022440393,845,3405,2.029585799,451,1621,2.594235033,1296,5026,3.87808642,179,559,2.122905028,277,650,1.346570397,456,1209,2.651315789,43,92,2.139534884
POA2116,476,953,2.00210084,596,2402,2.030201342,239,834,2.489539749,835,3236,3.875449102,133,401,2.015037594,180,432,1.4,313,833,2.661341853,25,54,2.16
POA2117,1537,3065,1.994144437,1652,6685,2.046610169,918,3250,2.540305011,2570,9935,3.865758755,334,973,1.913173653,438,1005,1.294520548,772,1978,2.562176166,75,166,2.213333333
POA2118,1913,3825,1.999477261,2046,8201,2.008308895,1327,4635,2.492840995,3373,12836,3.805514379,284,809,1.848591549,468,1097,1.344017094,752,1906,2.534574468,82,174,2.12195122
POA2119,981,1943,1.980632008,1028,4272,2.155642023,758,2669,2.521108179,1786,6941,3.886338186,89,268,2.011235955,179,405,1.262569832,268,673,2.51119403,37,86,2.324324324
POA2120,1734,3448,1.988465975,1933,7881,2.077082256,1152,4011,2.481770833,3085,11892,3.854781199,226,648,1.867256637,400,951,1.3775,626,1599,2.554313099,68,139,2.044117647
POA2121,2120,4218,1.989622642,2260,8940,1.955752212,1558,5405,2.469191271,3818,14345,3.757202724,267,733,1.745318352,510,1161,1.276470588,777,1894,2.437580438,146,313,2.143835616
POA2122,2590,5188,2.003088803,2202,8400,1.814713896,1354,4706,2.47562777,3556,13106,3.6856018,336,888,1.642857143,656,1505,1.294207317,992,2393,2.412298387,210,447,2.128571429
POA2125,1330,2654,1.995488722,1499,6221,2.150100067,1303,4619,2.544896393,2802,10840,3.868665239,135,381,1.822222222,247,591,1.392712551,382,972,2.544502618,38,93,2.447368421
POA2126,1365,2736,2.004395604,1842,7533,2.089576547,1456,5169,2.550137363,3298,12702,3.851425106,188,546,1.904255319,363,898,1.473829201,551,1444,2.620689655,41,87,2.12195122
POA2127,985,1933,1.962436548,789,2911,1.689480355,240,799,2.329166667,1029,3710,3.605442177,107,283,1.644859813,114,258,1.263157895,221,541,2.447963801,51,110,2.156862745
POA2128,159,317,1.993710692,175,754,2.308571429,47,176,2.744680851,222,930,4.189189189,43,121,1.813953488,32,79,1.46875,75,200,2.666666667,13,32,2.461538462
POA2129,0,0,#DIV/0!,0,0,#DIV/0!,0,4,#DIV/0!,0,4,#DIV/0!,0,0,#DIV/0!,0,0,#DIV/0!,0,0,#DIV/0!,0,0,#DIV/0!
POA2130,670,1326,1.979104478,485,1795,1.701030928,181,583,2.220994475,666,2378,3.570570571,95,221,1.326315789,126,268,1.126984127,221,489,2.212669683,49,104,2.12244898
POA2131,2233,4528,2.027765338,1558,5775,1.706675225,651,2203,2.384024578,2209,7978,3.611588954,366,952,1.601092896,490,1098,1.240816327,856,2050,2.394859813,209,457,2.186602871
POA2132,792,1583,1.998737374,888,3540,1.986486486,518,1809,2.492277992,1406,5349,3.804409673,142,415,1.922535211,243,555,1.283950617,385,970,2.519480519,69,147,2.130434783
POA2133,857,1719,2.005834306,960,3871,2.032291667,528,1885,2.570075758,1488,5756,3.86827957,196,558,1.846938776,317,720,1.271293375,513,1278,2.49122807,52,107,2.057692308
POA2134,1078,2201,2.04174397,775,2992,1.860645161,527,1853,2.516129032,1302,4845,3.721198157,175,475,1.714285714,321,731,1.277258567,496,1206,2.431451613,142,311,2.190140845
POA2135,1910,3898,2.040837696,1592,6524,2.09798995,1192,4305,2.611577181,2784,10829,3.889727011,248,685,1.762096774,475,1124,1.366315789,723,1809,2.502074689,222,481,2.166666667
POA2136,498,1017,2.042168675,556,2276,2.09352518,404,1438,2.559405941,960,3714,3.86875,111,321,1.891891892,182,427,1.346153846,293,748,2.552901024,35,71,2.028571429
POA2137,2342,4655,1.987617421,2127,8399,1.948754114,1197,4109,2.432748538,3324,12508,3.762936221,310,838,1.703225806,521,1203,1.309021113,831,2041,2.456077016,112,240,2.142857143
POA2138,1435,2877,2.004878049,1110,4214,1.796396396,539,1833,2.400742115,1649,6047,3.667070952,150,405,1.7,254,593,1.334645669,404,998,2.47029703,104,217,2.086538462
POA2139,0,4,#DIV/0!,0,0,#DIV/0!,0,0,#DIV/0!,0,0,#DIV/0!,0,0,#DIV/0!,0,0,#DIV/0!,0,0,#DIV/0!,0,0,#DIV/0!
POA2140,1132,2320,2.049469965,1072,3985,1.717350746,453,1598,2.527593819,1525,5583,3.660983607,182,510,1.802197802,279,649,1.326164875,461,1159,2.514099783,91,199,2.186813187
POA2141,1904,3906,2.051470588,2130,8877,2.167605634,1348,4876,2.617210682,3478,13753,3.954284071,427,1346,2.152224824,649,1578,1.431432974,1076,2924,2.717472119,204,448,2.196078431
POA2142,1535,3145,2.048859935,1906,8086,2.242392445,785,2895,2.687898089,2691,10981,4.080639168,454,1463,2.22246696,538,1299,1.414498141,992,2762,2.784274194,149,325,2.181208054
POA2143,451,893,1.980044346,611,2685,2.394435352,369,1308,2.544715447,980,3993,4.074489796,193,640,2.316062176,211,501,1.374407583,404,1141,2.824257426,33,87,2.636363636
POA2144,2054,4242,2.065238559,3027,13333,2.404691113,1362,4967,2.646842878,4389,18300,4.169514696,567,1879,2.313932981,671,1663,1.478390462,1238,3542,2.861066236,246,579,2.353658537
POA2145,6082,12349,2.030417626,7108,28053,1.946679797,2930,10396,2.548122867,10038,38449,3.83034469,1310,3949,2.014503817,1587,3730,1.350346566,2897,7679,2.65067311,398,851,2.138190955
POA2146,1322,2656,2.009077156,1506,6063,2.025896414,795,2814,2.539622642,2301,8877,3.857887875,339,979,1.887905605,324,774,1.388888889,663,1753,2.644042232,57,125,2.192982456
POA2147,2950,5931,2.010508475,3140,12941,2.12133758,1729,5991,2.465008676,4869,18932,3.888272746,795,2405,2.025157233,965,2226,1.306735751,1760,4631,2.63125,158,338,2.139240506
POA2148,4711,9632,2.044576523,5432,22293,2.104013255,2521,8918,2.537485125,7953,31211,3.924431032,1439,4494,2.123002085,1476,3488,1.363143631,2915,7982,2.738250429,327,702,2.146788991
POA2150,2632,5362,2.037234043,2066,7337,1.551306873,459,1586,2.455337691,2525,8923,3.533861386,341,918,1.692082111,415,963,1.320481928,756,1881,2.488095238,264,567,2.147727273
POA2151,1824,3646,1.998903509,1683,6625,1.936423054,793,2750,2.467843632,2476,9375,3.78634895,336,960,1.857142857,454,1037,1.284140969,790,1997,2.527848101,108,245,2.268518519
POA2152,1100,2189,1.99,908,3533,1.890969163,356,1218,2.421348315,1264,4751,3.758702532,178,486,1.730337079,237,543,1.291139241,415,1029,2.479518072,57,119,2.087719298
POA2153,4773,9537,1.998114393,5493,22301,2.059894411,2895,10128,2.498445596,8388,32429,3.866118264,681,1992,1.925110132,986,2287,1.319472617,1667,4279,2.566886623,131,280,2.13740458
POA2154,3228,6402,1.983271375,3614,14862,2.112340897,2369,8389,2.541156606,5983,23251,3.886177503,429,1249,1.911421911,661,1557,1.355521936,1090,2806,2.574311927,101,222,2.198019802
POA2155,2773,5556,2.003606203,5785,24150,2.174589455,2163,7723,2.57050393,7948,31873,4.010191243,578,1736,2.003460208,533,1316,1.469043152,1111,3052,2.747074707,92,201,2.184782609
POA2156,1131,2232,1.973474801,1091,4770,2.372135655,904,3171,2.507743363,1995,7941,3.980451128,117,350,1.991452991,190,452,1.378947368,307,802,2.61237785,30,64,2.133333333
POA2157,336,675,2.008928571,346,1539,2.447976879,204,742,2.637254902,550,2281,4.147272727,49,123,1.510204082,65,158,1.430769231,114,281,2.464912281,12,20,1.666666667
POA2158,736,1465,1.99048913,725,3073,2.23862069,529,1862,2.519848771,1254,4935,3.935406699,129,399,2.093023256,121,294,1.429752066,250,693,2.772,24,46,1.916666667
POA2159,425,844,1.985882353,385,1664,2.322077922,275,956,2.476363636,660,2620,3.96969697,57,174,2.052631579,85,204,1.4,142,378,2.661971831,10,20,2
POA2160,2274,4632,2.036939314,2822,12176,2.314670446,1364,5054,2.705278592,4186,17230,4.11610129,783,2485,2.173690932,844,2064,1.44549763,1627,4549,2.795943454,207,457,2.207729469
POA2161,1694,3442,2.031877214,2470,11439,2.631174089,1163,4349,2.739466896,3633,15788,4.345719791,649,2233,2.440677966,725,1768,1.43862069,1374,4001,2.911935953,169,382,2.26035503
POA2162,1062,2167,2.040489642,1458,6538,2.484224966,810,2924,2.609876543,2268,9462,4.171957672,426,1426,2.34741784,534,1295,1.425093633,960,2721,2.834375,94,208,2.212765957
POA2163,476,977,2.052521008,607,2733,2.50247117,304,1114,2.664473684,911,3847,4.222832053,286,926,2.237762238,314,734,1.337579618,600,1660,2.766666667,54,112,2.074074074
POA2164,1387,2801,2.019466474,1433,6272,2.376831821,1054,3824,2.628083491,2487,10096,4.059509449,447,1424,2.185682327,526,1334,1.536121673,973,2758,2.834532374,98,209,2.132653061
POA2165,2422,4980,2.056151941,3296,14579,2.423240291,1975,7339,2.715949367,5271,21918,4.158224246,1132,3770,2.330388693,1311,3242,1.472921434,2443,7012,2.870241506,263,590,2.243346008
POA2166,2894,6042,2.087767795,3923,16819,2.287280143,2179,7975,2.65993575,6102,24794,4.063257948,1886,5919,2.138388123,1694,4211,1.485832349,3580,10130,2.829608939,369,819,2.219512195
POA2167,601,1230,2.046589018,645,2598,2.027906977,375,1284,2.424,1020,3882,3.805882353,171,496,1.900584795,173,413,1.387283237,344,909,2.64244186,32,65,2.03125
POA2168,2076,4247,2.045761079,3660,16442,2.492349727,2091,7683,2.674318508,5751,24125,4.194922622,1344,4478,2.331845238,1227,3105,1.530562347,2571,7583,2.949436017,170,384,2.258823529
POA2170,6322,12803,2.025150269,8800,37114,2.2175,4425,15786,2.567457627,13225,52900,4,2373,7416,2.125158028,2377,5724,1.408077408,4750,13140,2.766315789,359,773,2.153203343
POA2171,1238,2517,2.033117932,2932,12544,2.278308322,1371,5129,2.741064916,4303,17673,4.107134557,441,1376,2.120181406,422,1057,1.504739336,863,2433,2.819235226,49,121,2.469387755
POA2172,164,318,1.93902439,273,1153,2.223443223,135,500,2.703703704,408,1653,4.051470588,21,65,2.095238095,18,44,1.444444444,39,109,2.794871795,7,13,1.857142857
POA2173,890,1774,1.993258427,1710,6856,2.009356725,537,1908,2.553072626,2247,8764,3.900311526,224,668,1.982142857,192,450,1.34375,416,1118,2.6875,25,50,2
POA2174,27,54,2,26,124,2.769230769,34,116,2.411764706,60,240,4,9,33,2.666666667,8,19,1.375,17,52,3.058823529,3,4,1.333333333
POA2175,126,259,2.055555556,132,604,2.575757576,133,503,2.781954887,265,1107,4.177358491,29,95,2.275862069,35,91,1.6,64,186,2.90625,10,19,1.9
POA2176,2967,6070,2.045837546,3811,16733,2.390711099,3565,13110,2.677419355,7376,29843,4.04595987,918,2917,2.177559913,1278,3302,1.58372457,2196,6219,2.831967213,178,416,2.337078652
POA2177,769,1585,2.061118336,1208,5335,2.416390728,1049,3894,2.712106768,2257,9229,4.089056269,495,1622,2.276767677,458,1225,1.674672489,953,2847,2.987408185,64,142,2.21875
POA2178,384,778,2.026041667,450,1980,2.4,288,1071,2.71875,738,3051,4.134146341,63,180,1.857142857,73,187,1.561643836,136,367,2.698529412,16,39,2.4375
POA2179,413,832,2.014527845,391,1812,2.6342711,286,1037,2.625874126,677,2849,4.208271787,100,320,2.2,108,265,1.453703704,208,585,2.8125,22,44,2
POA2190,1308,2642,2.019877676,2253,10686,2.743009321,1217,4567,2.752670501,3470,15253,4.395677233,537,1875,2.491620112,650,1626,1.501538462,1187,3501,2.949452401,77,169,2.194805195
POA2191,452,907,2.006637168,544,2297,2.222426471,322,1144,2.552795031,866,3441,3.973441109,111,339,2.054054054,184,427,1.320652174,295,766,2.596610169,25,61,2.44
POA2192,937,1901,2.028815368,1016,4286,2.218503937,590,2119,2.591525424,1606,6405,3.988169365,297,895,2.013468013,345,830,1.405797101,642,1725,2.686915888,80,186,2.325
POA2193,1257,2532,2.014319809,1162,4649,2.000860585,760,2661,2.501315789,1922,7310,3.803329865,268,739,1.757462687,360,816,1.266666667,628,1555,2.47611465,85,190,2.235294118
POA2194,1773,3654,2.060913706,1768,6841,1.869343891,949,3264,2.439409905,2717,10105,3.719175561,460,1285,1.793478261,586,1373,1.343003413,1046,2658,2.541108987,176,381,2.164772727
POA2195,1535,3161,2.059283388,2686,11145,2.149292628,756,2728,2.608465608,3442,13873,4.03050552,548,1668,2.04379562,470,1119,1.380851064,1018,2787,2.737721022,170,375,2.205882353
POA2196,1754,3565,2.032497149,2714,12175,2.485998526,1421,5304,2.732582688,4135,17479,4.227085852,616,2002,2.25,741,1833,1.473684211,1357,3835,2.826086957,148,338,2.283783784
POA2197,537,1075,2.001862197,687,3056,2.448326055,404,1453,2.596534653,1091,4509,4.132905591,198,661,2.338383838,237,580,1.447257384,435,1241,2.852873563,35,67,1.914285714
POA2198,721,1445,2.004160888,737,3199,2.340569878,480,1710,2.5625,1217,4909,4.0336894,165,538,2.260606061,195,481,1.466666667,360,1019,2.830555556,29,64,2.206896552
POA2199,992,2024,2.040322581,1386,6208,2.479076479,755,2741,2.630463576,2141,8949,4.179822513,384,1295,2.372395833,397,968,1.438287154,781,2263,2.897567222,71,154,2.169014085
POA2200,2561,5229,2.041780554,3641,15498,2.256522933,1682,6088,2.619500595,5323,21586,4.055232012,1087,3410,2.137074517,1069,2587,1.420018709,2156,5997,2.781539889,219,481,2.196347032
POA2203,1274,2541,1.994505495,1010,3822,1.784158416,358,1224,2.418994413,1368,5046,3.688596491,297,772,1.599326599,297,661,1.225589226,594,1433,2.412457912,102,213,2.088235294
POA2204,2354,4710,2.000849618,1727,6629,1.838448176,776,2728,2.515463918,2503,9357,3.738314023,490,1367,1.789795918,630,1450,1.301587302,1120,2817,2.515178571,193,412,2.134715026
POA2205,1225,2481,2.025306122,1003,4245,2.232303091,498,1748,2.510040161,1501,5993,3.992671552,195,616,2.158974359,285,671,1.354385965,480,1287,2.68125,93,190,2.043010753
POA2206,1638,3299,2.014041514,1656,6756,2.079710145,1083,3751,2.463527239,2739,10507,3.836071559,279,786,1.817204301,509,1169,1.296660118,788,1955,2.480964467,68,134,1.970588235
POA2207,2197,4440,2.020937642,2517,10402,2.132697656,1351,4738,2.507031828,3868,15140,3.914167528,473,1433,2.029598309,676,1590,1.352071006,1149,3023,2.630983464,145,314,2.165517241
POA2208,1017,2069,2.034414946,974,3967,2.072895277,738,2533,2.432249322,1712,6500,3.796728972,168,517,2.077380952,341,795,1.331378299,509,1312,2.577603143,56,120,2.142857143
POA2209,1243,2528,2.03378922,1214,4917,2.050247117,759,2672,2.520421607,1973,7589,3.846426761,243,702,1.888888889,393,914,1.325699746,636,1616,2.540880503,82,174,2.12195122
POA2210,2486,5016,2.017699115,2313,9552,2.129701686,1440,5002,2.473611111,3753,14554,3.877964295,473,1457,2.080338266,713,1659,1.326788219,1186,3116,2.627318718,125,265,2.12
POA2211,1405,2839,2.020640569,1342,5540,2.128166915,857,3032,2.537922987,2199,8572,3.898135516,303,885,1.920792079,434,1006,1.31797235,737,1891,2.565807327,77,164,2.12987013
POA2212,1094,2197,2.008226691,1215,5021,2.132510288,693,2444,2.526695527,1908,7465,3.912473795,291,929,2.192439863,414,950,1.29468599,705,1879,2.665248227,86,195,2.26744186
POA2213,1710,3432,2.007017544,1844,7677,2.163232104,1082,3842,2.550831793,2926,11519,3.936773753,366,1105,2.019125683,543,1285,1.366482505,909,2390,2.629262926,79,163,2.063291139
POA2214,401,809,2.017456359,348,1439,2.135057471,230,807,2.508695652,578,2246,3.885813149,57,175,2.070175439,80,186,1.325,137,361,2.635036496,5,14,2.8
POA2216,2608,5299,2.031825153,1887,7356,1.898251192,987,3384,2.428571429,2874,10740,3.736951983,416,1205,1.896634615,650,1501,1.309230769,1066,2706,2.538461538,215,468,2.176744186
POA2217,2308,4678,2.026863085,2045,7912,1.868948655,930,3186,2.425806452,2975,11098,3.730420168,400,1120,1.8,590,1340,1.271186441,990,2460,2.484848485,162,355,2.191358025
POA2218,1429,2882,2.016794962,1316,5099,1.874620061,677,2297,2.392909897,1993,7396,3.71098846,282,775,1.74822695,393,906,1.305343511,675,1681,2.49037037,99,207,2.090909091
POA2219,1343,2679,1.994787789,981,3850,1.924566769,551,1861,2.377495463,1532,5711,3.727806789,216,601,1.782407407,295,669,1.26779661,511,1270,2.485322896,60,123,2.05
POA2220,2591,5268,2.033191818,2313,8946,1.86770428,1321,4560,2.451930356,3634,13506,3.716565768,523,1514,1.894837476,722,1688,1.337950139,1245,3202,2.57188755,236,509,2.156779661
POA2221,1254,2512,2.003189793,1428,5956,2.170868347,973,3426,2.521068859,2401,9382,3.907538526,221,685,2.099547511,339,793,1.339233038,560,1478,2.639285714,70,156,2.228571429
POA2222,1041,2118,2.034582133,1044,4087,1.914750958,532,1836,2.45112782,1576,5923,3.758248731,203,555,1.733990148,303,686,1.264026403,506,1241,2.45256917,57,118,2.070175439
POA2223,1874,3740,1.995731057,1777,7114,2.003376477,991,3450,2.481331988,2768,10564,3.816473988,277,759,1.740072202,473,1072,1.266384778,750,1831,2.441333333,98,195,1.989795918
POA2224,1470,2936,1.997278912,1077,4356,2.044568245,715,2489,2.481118881,1792,6845,3.819754464,220,627,1.85,302,692,1.291390728,522,1319,2.526819923,40,79,1.975
POA2225,455,901,1.98021978,592,2437,2.116554054,311,1076,2.459807074,903,3513,3.890365449,71,204,1.873239437,94,217,1.308510638,165,421,2.551515152,9,18,2
POA2226,1047,2091,1.99713467,1191,4817,2.04450042,605,2124,2.510743802,1796,6941,3.864699332,159,456,1.867924528,233,537,1.30472103,392,993,2.533163265,36,85,2.361111111
POA2227,1378,2727,1.978955007,1355,5523,2.07601476,669,2325,2.475336323,2024,7848,3.877470356,208,571,1.745192308,319,741,1.322884013,527,1312,2.489563567,46,92,2
POA2228,1782,3531,1.981481481,1422,5685,1.997890295,740,2540,2.432432432,2162,8225,3.804347826,347,947,1.729106628,447,1038,1.322147651,794,1985,2.5,81,167,2.061728395
POA2229,2680,5304,1.979104478,2399,9765,2.070446019,1280,4436,2.465625,3679,14201,3.860016309,437,1206,1.7597254,594,1309,1.203703704,1031,2515,2.439379243,95,199,2.094736842
POA2230,3140,6187,1.970382166,1879,7489,1.985630655,1049,3570,2.403241182,2928,11059,3.776980874,460,1183,1.57173913,580,1248,1.151724138,1040,2431,2.3375,139,279,2.007194245
POA2231,176,353,2.005681818,234,960,2.102564103,97,332,2.422680412,331,1292,3.903323263,54,160,1.962962963,61,147,1.409836066,115,307,2.669565217,7,15,2.142857143
POA2232,3217,6370,1.980105689,2743,10911,1.977761575,1311,4532,2.456903127,4054,15443,3.809324124,541,1496,1.765249538,708,1599,1.258474576,1249,3095,2.477982386,116,234,2.017241379
POA2233,2625,5208,1.984,3005,12453,2.144093178,1663,5829,2.505111245,4668,18282,3.916452442,392,1171,1.987244898,523,1200,1.294455067,915,2371,2.591256831,72,153,2.125
POA2234,2214,4400,1.987353207,2888,12093,2.18732687,2389,8584,2.593135203,5277,20677,3.918324806,457,1360,1.975929978,599,1483,1.475792988,1056,2843,2.692234848,59,129,2.186440678
POA2250,6190,12290,1.98546042,5250,21545,2.103809524,2497,8456,2.386463757,7747,30001,3.872595844,1559,4590,1.944194997,1594,3547,1.225219573,3153,8137,2.580716778,195,403,2.066666667
POA2251,3345,6609,1.975784753,2618,10819,2.132543927,1372,4614,2.362973761,3990,15433,3.867919799,668,1927,1.884730539,694,1574,1.268011527,1362,3501,2.570484581,76,163,2.144736842
POA2256,1641,3249,1.979890311,920,3701,2.022826087,501,1660,2.313373253,1421,5361,3.772695285,379,1085,1.862796834,454,981,1.160792952,833,2066,2.480192077,68,148,2.176470588
POA2257,3153,6280,1.991753885,1822,7440,2.083424808,908,2989,2.29185022,2730,10429,3.82014652,842,2431,1.887173397,745,1621,1.175838926,1587,4052,2.553245117,125,255,2.04
POA2258,462,912,1.974025974,443,1886,2.257336343,246,851,2.459349593,689,2737,3.972423803,138,387,1.804347826,96,215,1.239583333,234,602,2.572649573,18,33,1.833333333
POA2259,5526,11029,1.995837857,4501,18844,2.186625194,1816,6114,2.366740088,6317,24958,3.950926073,1601,4937,2.083697689,1137,2544,1.237467018,2738,7481,2.73228634,160,334,2.0875
POA2260,2349,4636,1.97360579,1814,7460,2.112458655,911,3081,2.381997805,2725,10541,3.868256881,427,1203,1.817330211,449,991,1.207126949,876,2194,2.50456621,80,165,2.0625
POA2261,5091,10161,1.995875074,3607,14925,2.137787635,1819,6117,2.362836723,5426,21042,3.87799484,1686,4903,1.908066429,1435,3190,1.222996516,3121,8093,2.593079141,181,371,2.049723757
POA2262,2056,4115,2.001459144,1553,6537,2.209272376,665,2195,2.30075188,2218,8732,3.936880072,750,2319,2.092,470,1056,1.246808511,1220,3375,2.766393443,69,144,2.086956522
POA2263,2414,4822,1.997514499,1284,5260,2.096573209,725,2420,2.337931034,2009,7680,3.822797412,815,2410,1.957055215,661,1485,1.246596067,1476,3895,2.638888889,100,203,2.03
POA2264,1695,3344,1.972861357,839,3476,2.143027414,435,1425,2.275862069,1274,4901,3.846938776,360,1044,1.9,301,675,1.242524917,661,1719,2.600605144,45,91,2.022222222
POA2265,564,1125,1.994680851,376,1595,2.242021277,214,723,2.378504673,590,2318,3.928813559,118,342,1.898305085,87,204,1.344827586,205,546,2.663414634,16,31,1.9375
POA2267,424,830,1.95754717,164,658,2.012195122,110,350,2.181818182,274,1008,3.678832117,71,205,1.887323944,46,86,0.869565217,117,291,2.487179487,4,17,4.25
POA2278,227,469,2.066079295,239,1022,2.276150628,157,531,2.382165605,396,1553,3.921717172,67,202,2.014925373,49,106,1.163265306,116,308,2.655172414,7,18,2.571428571
POA2280,3002,5966,1.987341772,2058,8489,2.124878523,1188,3983,2.352693603,3246,12472,3.842267406,648,1904,1.938271605,575,1283,1.231304348,1223,3187,2.605887163,98,206,2.102040816
POA2281,1612,3204,1.987593052,891,3639,2.084175084,572,1887,2.298951049,1463,5526,3.777170198,309,910,1.944983819,307,682,1.221498371,616,1592,2.584415584,61,127,2.081967213
POA2282,1708,3374,1.975409836,1208,4973,2.116721854,692,2337,2.37716763,1900,7310,3.847368421,267,727,1.722846442,286,641,1.241258741,553,1368,2.473779385,40,82,2.05
POA2283,2828,5609,1.983380481,1477,6078,2.115098172,963,3191,2.313603323,2440,9269,3.798770492,657,2021,2.076103501,579,1290,1.227979275,1236,3311,2.678802589,74,156,2.108108108
POA2284,1116,2226,1.994623656,708,2869,2.052259887,395,1313,2.324050633,1103,4182,3.791477788,331,953,1.879154079,288,639,1.21875,619,1592,2.571890145,40,83,2.075
POA2285,2795,5568,1.992128801,2471,9984,2.040469446,1098,3675,2.346994536,3569,13659,3.827122443,734,2131,1.903269755,604,1351,1.236754967,1338,3482,2.602391629,102,214,2.098039216
POA2286,323,657,2.034055728,294,1214,2.129251701,147,496,2.37414966,441,1710,3.87755102,125,342,1.736,77,162,1.103896104,202,504,2.495049505,15,30,2
POA2287,3221,6399,1.986650109,2791,11276,2.040128986,1364,4603,2.374633431,4155,15879,3.82166065,844,2464,1.91943128,737,1671,1.267299864,1581,4135,2.61543327,147,304,2.068027211
POA2289,2049,4067,1.984870669,1651,6612,2.004845548,739,2474,2.347767253,2390,9086,3.80167364,374,1028,1.748663102,432,949,1.196759259,806,1977,2.452853598,68,141,2.073529412
POA2290,3442,6843,1.988088321,2547,10271,2.032587358,1332,4492,2.372372372,3879,14763,3.805877804,805,2318,1.879503106,818,1804,1.205378973,1623,4122,2.53974122,117,235,2.008547009
POA2291,1384,2717,1.963150289,1035,4123,1.983574879,520,1735,2.336538462,1555,5858,3.767202572,177,457,1.581920904,234,512,1.188034188,411,969,2.357664234,76,158,2.078947368
POA2292,218,427,1.958715596,174,673,1.867816092,56,191,2.410714286,230,864,3.756521739,71,208,1.929577465,81,177,1.185185185,152,385,2.532894737,13,28,2.153846154
POA2293,241,475,1.970954357,126,454,1.603174603,36,118,2.277777778,162,572,3.530864198,52,125,1.403846154,69,151,1.188405797,121,276,2.280991736,14,34,2.428571429
POA2294,188,375,1.994680851,108,398,1.685185185,27,79,1.925925926,135,477,3.533333333,67,170,1.537313433,64,143,1.234375,131,313,2.389312977,18,34,1.888888889
POA2295,655,1291,1.970992366,331,1300,1.927492447,184,603,2.277173913,515,1903,3.695145631,134,376,1.805970149,165,355,1.151515152,299,731,2.444816054,22,48,2.181818182
POA2296,183,361,1.972677596,96,368,1.833333333,15,48,2.2,111,416,3.747747748,68,175,1.573529412,48,103,1.145833333,116,278,2.396551724,23,37,1.608695652
POA2297,147,288,1.959183673,117,459,1.923076923,34,104,2.058823529,151,563,3.728476821,50,128,1.56,42,96,1.285714286,92,224,2.434782609,9,20,2.222222222
POA2298,821,1629,1.984165652,586,2279,1.889078498,225,733,2.257777778,811,3012,3.713933416,247,694,1.809716599,272,585,1.150735294,519,1279,2.464354528,68,140,2.058823529
POA2299,944,1876,1.987288136,724,2874,1.96961326,321,1063,2.31152648,1045,3937,3.767464115,291,789,1.711340206,280,615,1.196428571,571,1404,2.458844133,66,133,2.015151515
POA2300,1184,2309,1.950168919,464,1782,1.840517241,203,621,2.0591133,667,2403,3.602698651,136,352,1.588235294,167,343,1.053892216,303,695,2.293729373,68,138,2.029411765
POA2302,62,129,2.080645161,20,63,1.15,7,17,1.428571429,27,80,2.962962963,10,29,1.9,11,23,1.090909091,21,52,2.476190476,4,8,2
POA2303,851,1674,1.967097532,603,2379,1.945273632,279,919,2.29390681,882,3298,3.739229025,195,534,1.738461538,231,506,1.19047619,426,1040,2.441314554,54,117,2.166666667
POA2304,1436,2851,1.985376045,937,3695,1.943436499,360,1214,2.372222222,1297,4909,3.784888204,399,1110,1.781954887,413,883,1.138014528,812,1993,2.454433498,103,203,1.970873786
POA2305,1159,2311,1.993960311,1029,4106,1.990281827,447,1502,2.360178971,1476,5608,3.799457995,216,590,1.731481481,273,602,1.205128205,489,1192,2.437627812,46,92,2
POA2306,200,394,1.97,132,599,2.537878788,95,306,2.221052632,227,905,3.986784141,205,646,2.151219512,136,293,1.154411765,341,939,2.753665689,26,57,2.192307692
POA2307,414,820,1.980676329,248,985,1.971774194,114,368,2.228070175,362,1353,3.737569061,88,255,1.897727273,102,240,1.352941176,190,495,2.605263158,23,39,1.695652174
POA2308,0,0,#DIV/0!,0,0,#DIV/0!,0,0,#DIV/0!,0,0,#DIV/0!,0,0,#DIV/0!,0,0,#DIV/0!,0,0,#DIV/0!,0,0,#DIV/0!
POA2311,114,224,1.964912281,57,229,2.01754386,41,123,2,98,352,3.591836735,15,43,1.866666667,14,32,1.285714286,29,75,2.586206897,0,3,#DIV/0!
POA2312,189,364,1.925925926,113,481,2.256637168,48,150,2.125,161,631,3.919254658,52,169,2.25,29,61,1.103448276,81,230,2.839506173,5,9,1.8
POA2314,0,0,#DIV/0!,0,0,#DIV/0!,0,0,#DIV/0!,0,0,#DIV/0!,0,0,#DIV/0!,0,0,#DIV/0!,0,0,#DIV/0!,0,0,#DIV/0!
POA2315,1800,3543,1.968333333,818,3310,2.046454768,382,1245,2.259162304,1200,4555,3.795833333,309,866,1.802588997,221,466,1.108597285,530,1332,2.513207547,32,71,2.21875
POA2316,632,1255,1.985759494,447,1859,2.158836689,190,642,2.378947368,637,2501,3.926216641,146,435,1.979452055,113,240,1.123893805,259,675,2.606177606,10,20,2
POA2317,924,1825,1.975108225,364,1515,2.162087912,169,545,2.224852071,533,2060,3.864915572,146,422,1.890410959,125,269,1.152,271,691,2.549815498,12,33,2.75
POA2318,1221,2401,1.966420966,1112,4564,2.104316547,469,1567,2.341151386,1581,6131,3.877925364,265,797,2.00754717,157,353,1.248407643,422,1150,2.725118483,26,53,2.038461538
POA2319,861,1699,1.973286876,437,1825,2.176201373,197,621,2.152284264,634,2446,3.858044164,196,605,2.086734694,120,260,1.166666667,316,865,2.737341772,19,41,2.157894737
POA2320,2857,5682,1.98879944,2671,11010,2.122051666,1101,3685,2.346957312,3772,14695,3.895811241,760,2299,2.025,563,1284,1.280639432,1323,3583,2.708238851,92,192,2.086956522
POA2321,1238,2469,1.994345719,995,4164,2.184924623,493,1654,2.354969574,1488,5818,3.909946237,205,580,1.829268293,217,485,1.235023041,422,1065,2.523696682,24,46,1.916666667
POA2322,1689,3347,1.981645944,1438,5956,2.1418637,725,2439,2.364137931,2163,8395,3.881183541,463,1414,2.05399568,358,803,1.24301676,821,2217,2.700365408,49,109,2.224489796
POA2323,2560,5079,1.983984375,2037,8438,2.142366225,977,3260,2.336745138,3014,11698,3.881220969,677,1997,1.949778434,523,1160,1.217973231,1200,3157,2.630833333,94,198,2.106382979
POA2324,2735,5447,1.991590494,1550,6519,2.205806452,777,2588,2.330759331,2327,9107,3.91362269,739,2196,1.971583221,489,1091,1.231083845,1228,3287,2.676710098,68,145,2.132352941
POA2325,2527,5032,1.991294025,1924,7956,2.135135135,882,2949,2.343537415,2806,10905,3.886315039,876,2588,1.9543379,596,1324,1.22147651,1472,3912,2.657608696,88,175,1.988636364
POA2326,691,1399,2.024602026,546,2293,2.1996337,276,905,2.278985507,822,3198,3.890510949,252,774,2.071428571,177,384,1.169491525,429,1158,2.699300699,28,60,2.142857143
POA2327,740,1470,1.986486486,512,2157,2.212890625,235,795,2.382978723,747,2952,3.951807229,307,905,1.947882736,211,470,1.227488152,518,1375,2.654440154,28,59,2.107142857
POA2328,252,499,1.98015873,201,854,2.248756219,82,268,2.268292683,283,1122,3.964664311,57,163,1.859649123,25,54,1.16,82,217,2.646341463,5,9,1.8
POA2329,260,519,1.996153846,161,682,2.236024845,44,133,2.022727273,205,815,3.975609756,58,191,2.293103448,31,64,1.064516129,89,255,2.865168539,12,21,1.75
POA2330,1970,3886,1.972588832,1903,7876,2.138728324,771,2587,2.35538262,2674,10463,3.912864622,438,1317,2.006849315,326,738,1.263803681,764,2055,2.689790576,47,100,2.127659574
POA2333,1232,2446,1.98538961,1137,4740,2.168865435,374,1219,2.259358289,1511,5959,3.943745864,362,1094,2.022099448,214,471,1.200934579,576,1565,2.717013889,61,122,2
POA2334,214,419,1.957943925,249,1070,2.297188755,71,249,2.507042254,320,1319,4.121875,72,217,2.013888889,49,110,1.244897959,121,327,2.702479339,11,18,1.636363636
POA2335,563,1115,1.980461812,580,2370,2.086206897,199,651,2.271356784,779,3021,3.87804878,115,354,2.07826087,77,184,1.38961039,192,538,2.802083333,7,21,3
POA2336,264,518,1.962121212,213,857,2.023474178,77,251,2.25974026,290,1108,3.820689655,55,153,1.781818182,40,93,1.325,95,246,2.589473684,5,15,3
POA2337,854,1688,1.976580796,695,2830,2.071942446,231,719,2.112554113,926,3549,3.832613391,169,467,1.763313609,117,254,1.170940171,286,721,2.520979021,15,30,2
POA2338,198,392,1.97979798,107,435,2.065420561,44,135,2.068181818,151,570,3.774834437,31,83,1.677419355,28,62,1.214285714,59,145,2.457627119,3,3,1
POA2339,91,188,2.065934066,59,245,2.152542373,13,39,2,72,284,3.944444444,9,23,1.555555556,12,20,0.666666667,21,43,2.047619048,0,0,#DIV/0!
POA2340,4874,9626,1.974969224,3413,14001,2.10225608,1394,4453,2.194404591,4807,18454,3.838984814,1464,4412,2.013661202,911,2005,1.200878156,2375,6417,2.701894737,189,388,2.052910053
POA2341,210,414,1.971428571,102,434,2.254901961,48,152,2.166666667,150,586,3.906666667,52,173,2.326923077,54,108,1,106,281,2.650943396,10,23,2.3
POA2342,83,160,1.927710843,52,194,1.730769231,18,58,2.222222222,70,252,3.6,7,21,2,8,15,0.875,15,36,2.4,6,11,1.833333333
POA2343,564,1107,1.962765957,317,1305,2.116719243,143,428,1.993006993,460,1733,3.767391304,118,372,2.152542373,80,168,1.1,198,540,2.727272727,25,51,2.04
POA2344,84,165,1.964285714,68,286,2.205882353,29,91,2.137931034,97,377,3.886597938,5,16,2.2,13,27,1.076923077,18,43,2.388888889,0,3,#DIV/0!
POA2345,112,218,1.946428571,59,248,2.203389831,30,94,2.133333333,89,342,3.842696629,11,43,2.909090909,7,9,0.285714286,18,52,2.888888889,6,9,1.5
POA2346,348,702,2.017241379,170,699,2.111764706,85,264,2.105882353,255,963,3.776470588,100,336,2.36,67,138,1.059701493,167,474,2.838323353,12,24,2
POA2347,266,523,1.966165414,119,464,1.899159664,43,131,2.046511628,162,595,3.672839506,37,121,2.27027027,43,87,1.023255814,80,208,2.6,11,25,2.272727273
POA2350,2459,4828,1.963399756,1766,7301,2.134201586,703,2295,2.26458037,2469,9596,3.886593763,684,2010,1.938596491,395,850,1.151898734,1079,2860,2.65060241,88,182,2.068181818
POA2351,0,0,#DIV/0!,0,0,#DIV/0!,0,0,#DIV/0!,0,0,#DIV/0!,0,0,#DIV/0!,0,0,#DIV/0!,0,0,#DIV/0!,0,0,#DIV/0!
POA2352,321,627,1.953271028,230,972,2.226086957,97,311,2.206185567,327,1283,3.923547401,81,240,1.962962963,46,92,1,127,332,2.614173228,4,11,2.75
POA2353,135,258,1.911111111,79,325,2.113924051,38,118,2.105263158,117,443,3.786324786,13,43,2.307692308,24,55,1.291666667,37,98,2.648648649,3,4,1.333333333
POA2354,499,975,1.953907816,275,1114,2.050909091,105,311,1.961904762,380,1425,3.75,66,221,2.348484848,52,98,0.884615385,118,319,2.703389831,14,28,2
POA2355,93,178,1.913978495,60,239,1.983333333,29,101,2.482758621,89,340,3.820224719,16,36,1.25,6,20,2.333333333,22,56,2.545454545,0,4,#DIV/0!
POA2357,531,1036,1.951035782,295,1283,2.349152542,112,350,2.125,407,1633,4.012285012,103,316,2.067961165,70,150,1.142857143,173,466,2.693641618,19,37,1.947368421
POA2358,500,969,1.938,290,1251,2.313793103,150,476,2.173333333,440,1727,3.925,89,273,2.06741573,63,149,1.365079365,152,422,2.776315789,20,39,1.95
POA2359,69,132,1.913043478,43,189,2.395348837,22,64,1.909090909,65,253,3.892307692,17,53,2.117647059,9,21,1.333333333,26,74,2.846153846,0,0,#DIV/0!
POA2360,1653,3275,1.981246219,1085,4572,2.213824885,424,1335,2.148584906,1509,5907,3.914512922,446,1408,2.156950673,242,537,1.219008264,688,1945,2.827034884,48,105,2.1875
POA2361,110,226,2.054545455,60,266,2.433333333,26,79,2.038461538,86,345,4.011627907,27,81,2,10,24,1.4,37,105,2.837837838,3,3,1
POA2365,397,798,2.010075567,275,1170,2.254545455,103,317,2.077669903,378,1487,3.933862434,63,188,1.984126984,60,127,1.116666667,123,315,2.56097561,13,24,1.846153846
POA2369,119,241,2.025210084,86,406,2.720930233,34,102,2,120,508,4.233333333,51,179,2.509803922,9,25,1.777777778,60,204,3.4,5,12,2.4
POA2370,961,1894,1.970863684,476,1980,2.159663866,185,575,2.108108108,661,2555,3.865355522,213,651,2.056338028,142,297,1.091549296,355,948,2.670422535,38,75,1.973684211
POA2371,121,246,2.033057851,40,171,2.275,23,62,1.695652174,63,233,3.698412698,12,38,2.166666667,14,25,0.785714286,26,63,2.423076923,3,7,2.333333333
POA2372,670,1306,1.949253731,302,1265,2.188741722,131,409,2.122137405,433,1674,3.866050808,120,396,2.3,84,179,1.130952381,204,575,2.818627451,21,45,2.142857143
POA2380,1076,2155,2.002788104,797,3334,2.183186951,295,937,2.176271186,1092,4271,3.911172161,285,859,2.014035088,167,385,1.305389222,452,1244,2.752212389,36,70,1.944444444
POA2381,186,376,2.021505376,139,607,2.366906475,68,201,1.955882353,207,808,3.903381643,42,124,1.952380952,28,59,1.107142857,70,183,2.614285714,8,18,2.25
POA2382,130,258,1.984615385,99,423,2.272727273,29,92,2.172413793,128,515,4.0234375,37,123,2.324324324,19,43,1.263157895,56,166,2.964285714,0,5,#DIV/0!
POA2386,37,71,1.918918919,27,107,1.962962963,5,15,2,32,122,3.8125,4,9,1.25,4,7,0.75,8,16,2,0,0,#DIV/0!
POA2388,301,593,1.970099668,253,1059,2.185770751,98,307,2.132653061,351,1366,3.891737892,77,258,2.350649351,42,94,1.238095238,119,352,2.957983193,15,26,1.733333333
POA2390,946,1867,1.973572939,668,2743,2.106287425,244,790,2.237704918,912,3533,3.873903509,203,623,2.068965517,137,291,1.124087591,340,914,2.688235294,27,62,2.296296296
POA2395,103,199,1.932038835,50,202,2.04,14,44,2.142857143,64,246,3.84375,28,97,2.464285714,6,15,1.5,34,112,3.294117647,3,7,2.333333333
POA2396,139,274,1.971223022,70,291,2.157142857,41,120,1.926829268,111,411,3.702702703,38,119,2.131578947,24,47,0.958333333,62,166,2.677419355,7,17,2.428571429
POA2397,54,101,1.87037037,36,148,2.111111111,9,31,2.444444444,45,179,3.977777778,4,16,3,7,14,1,11,30,2.727272727,0,3,#DIV/0!
POA2399,107,217,2.028037383,77,321,2.168831169,28,95,2.392857143,105,416,3.961904762,12,40,2.333333333,16,32,1,28,72,2.571428571,3,8,2.666666667
POA2400,927,1827,1.970873786,783,3144,2.01532567,246,802,2.260162602,1029,3946,3.834791059,324,994,2.067901235,182,411,1.258241758,506,1405,2.776679842,52,105,2.019230769
POA2401,35,74,2.114285714,30,119,1.966666667,10,36,2.6,40,155,3.875,6,24,3,8,12,0.5,14,36,2.571428571,5,3,0.6
POA2402,253,485,1.916996047,152,622,2.092105263,57,164,1.877192982,209,786,3.76076555,41,113,1.756097561,32,65,1.03125,73,178,2.438356164,6,11,1.833333333
POA2403,79,149,1.886075949,44,189,2.295454545,21,54,1.571428571,65,243,3.738461538,7,25,2.571428571,7,14,1,14,39,2.785714286,0,4,#DIV/0!
POA2404,274,547,1.996350365,110,460,2.181818182,52,158,2.038461538,162,618,3.814814815,34,96,1.823529412,23,50,1.173913043,57,146,2.561403509,4,3,0.75
POA2405,55,101,1.836363636,50,213,2.26,15,48,2.2,65,261,4.015384615,9,24,1.666666667,8,17,1.125,17,41,2.411764706,4,5,1.25
POA2406,76,148,1.947368421,65,259,1.984615385,9,30,2.333333333,74,289,3.905405405,22,83,2.772727273,12,20,0.666666667,34,103,3.029411765,0,4,#DIV/0!
POA2408,50,97,1.94,44,198,2.5,11,32,1.909090909,55,230,4.181818182,6,12,1,0,6,#DIV/0!,6,18,3,0,0,#DIV/0!
POA2409,76,161,2.118421053,91,444,2.879120879,25,79,2.16,116,523,4.50862069,54,195,2.611111111,16,42,1.625,70,237,3.385714286,3,13,4.333333333
POA2410,60,115,1.916666667,25,103,2.12,11,37,2.363636364,36,140,3.888888889,8,21,1.625,3,3,0,11,24,2.181818182,0,0,#DIV/0!
POA2415,32,58,1.8125,26,103,1.961538462,13,39,2,39,142,3.641025641,4,16,3,3,6,1,7,22,3.142857143,0,0,#DIV/0!
POA2420,494,979,1.981781377,294,1219,2.146258503,157,489,2.114649682,451,1708,3.78713969,99,268,1.707070707,84,186,1.214285714,183,454,2.480874317,10,18,1.8
POA2421,191,378,1.979057592,124,533,2.298387097,71,234,2.295774648,195,767,3.933333333,24,75,2.125,15,33,1.2,39,108,2.769230769,5,4,0.8
POA2422,794,1561,1.965994962,332,1342,2.042168675,154,497,2.227272727,486,1839,3.783950617,106,331,2.122641509,77,164,1.12987013,183,495,2.704918033,22,42,1.909090909
POA2423,421,826,1.961995249,199,795,1.994974874,109,343,2.146788991,308,1138,3.694805195,85,268,2.152941176,77,165,1.142857143,162,433,2.672839506,14,25,1.785714286
POA2424,52,111,2.134615385,31,135,2.35483871,17,54,2.176470588,48,189,3.9375,14,35,1.5,7,17,1.428571429,21,52,2.476190476,6,7,1.166666667
POA2425,177,345,1.949152542,135,586,2.340740741,59,183,2.101694915,194,769,3.963917526,27,84,2.111111111,26,51,0.961538462,53,135,2.547169811,6,16,2.666666667
POA2426,65,133,2.046153846,35,148,2.228571429,16,43,1.6875,51,191,3.745098039,10,28,1.8,12,22,0.833333333,22,50,2.272727273,0,3,#DIV/0!
POA2427,459,915,1.993464052,110,449,2.081818182,50,160,2.2,160,609,3.80625,58,161,1.775862069,44,98,1.227272727,102,259,2.539215686,4,10,2.5
POA2428,3507,6909,1.97005988,1118,4580,2.096601073,547,1741,2.182815356,1665,6321,3.796396396,622,1850,1.974276527,472,987,1.091101695,1094,2837,2.593235832,77,155,2.012987013
POA2429,1240,2459,1.983064516,578,2450,2.238754325,302,962,2.185430464,880,3412,3.877272727,276,818,1.963768116,188,407,1.164893617,464,1225,2.640086207,31,69,2.225806452
POA2430,4154,8230,1.981222918,2101,8882,2.227510709,955,3075,2.219895288,3056,11957,3.91263089,1023,3090,2.020527859,673,1463,1.17384844,1696,4553,2.684551887,96,196,2.041666667
POA2431,783,1546,1.974457216,274,1162,2.240875912,129,400,2.100775194,403,1562,3.875930521,124,349,1.814516129,95,196,1.063157895,219,545,2.488584475,12,32,2.666666667
POA2439,337,660,1.958456973,179,742,2.145251397,99,321,2.242424242,278,1063,3.823741007,56,177,2.160714286,44,95,1.159090909,100,272,2.72,11,23,2.090909091
POA2440,2252,4471,1.985346359,1264,5485,2.339398734,603,1912,2.170812604,1867,7397,3.961971077,871,2831,2.250287026,487,1077,1.211498973,1358,3908,2.877761414,89,182,2.04494382
POA2441,820,1629,1.986585366,457,1944,2.253829322,266,846,2.180451128,723,2790,3.858921162,136,405,1.977941176,123,274,1.227642276,259,679,2.621621622,13,32,2.461538462
POA2443,1541,3069,1.99156392,406,1681,2.140394089,210,659,2.138095238,616,2340,3.798701299,200,609,2.045,152,316,1.078947368,352,925,2.627840909,14,28,2
POA2444,5809,11480,1.97624376,2857,11576,2.05180259,1122,3612,2.219251337,3979,15188,3.817039457,1153,3191,1.767562879,889,1900,1.137232846,2042,5091,2.493143976,133,261,1.962406015
POA2445,779,1536,1.971758665,510,2107,2.131372549,178,567,2.185393258,688,2674,3.886627907,136,397,1.919117647,125,268,1.144,261,665,2.54789272,16,38,2.375
POA2446,1532,3043,1.986292428,939,3983,2.241746539,417,1327,2.182254197,1356,5310,3.915929204,373,1100,1.949061662,241,530,1.199170124,614,1630,2.654723127,33,68,2.060606061
POA2447,902,1796,1.99113082,430,1819,2.230232558,185,573,2.097297297,615,2392,3.889430894,198,608,2.070707071,138,291,1.108695652,336,899,2.675595238,26,53,2.038461538
POA2448,1227,2441,1.989405053,446,1854,2.156950673,198,616,2.111111111,644,2470,3.835403727,275,869,2.16,175,381,1.177142857,450,1250,2.777777778,34,71,2.088235294
POA2449,280,558,1.992857143,133,597,2.488721805,54,157,1.907407407,187,754,4.032085561,102,335,2.284313725,66,150,1.272727273,168,485,2.886904762,14,32,2.285714286
POA2450,4292,8475,1.974603914,2690,11047,2.10669145,1140,3690,2.236842105,3830,14737,3.847780679,1158,3348,1.89119171,755,1624,1.150993377,1913,4972,2.59905907,108,220,2.037037037
POA2452,1675,3301,1.970746269,1068,4382,2.102996255,446,1442,2.233183857,1514,5824,3.84676354,545,1589,1.91559633,377,837,1.220159151,922,2426,2.631236443,43,85,1.976744186
POA2453,362,706,1.950276243,189,764,2.042328042,63,195,2.095238095,252,959,3.805555556,64,175,1.734375,57,119,1.087719298,121,294,2.429752066,11,22,2
POA2454,803,1567,1.95143213,571,2316,2.056042032,209,654,2.129186603,780,2970,3.807692308,273,766,1.805860806,169,352,1.082840237,442,1118,2.529411765,19,40,2.105263158
POA2455,473,943,1.993657505,153,664,2.339869281,87,275,2.16091954,240,939,3.9125,93,284,2.053763441,70,147,1.1,163,431,2.644171779,5,8,1.6
POA2456,1778,3521,1.980314961,981,4041,2.119266055,442,1385,2.133484163,1423,5426,3.813070977,409,1205,1.946210269,270,594,1.2,679,1799,2.649484536,41,90,2.195121951
POA2460,3289,6485,1.971723928,1932,8176,2.231884058,860,2753,2.201162791,2792,10929,3.914398281,945,2812,1.975661376,581,1259,1.166953528,1526,4071,2.667758847,114,246,2.157894737
POA2462,320,631,1.971875,155,645,2.161290323,79,262,2.316455696,234,907,3.876068376,78,249,2.192307692,42,95,1.261904762,120,344,2.866666667,8,16,2
POA2463,1016,2016,1.984251969,489,2054,2.200408998,213,677,2.178403756,702,2731,3.89031339,179,548,2.061452514,126,265,1.103174603,305,813,2.66557377,25,51,2.04
POA2464,1051,2068,1.967649857,341,1367,2.008797654,167,533,2.191616766,508,1900,3.74015748,165,470,1.848484848,127,279,1.196850394,292,749,2.565068493,25,55,2.2
POA2465,39,82,2.102564103,26,105,2.038461538,13,40,2.076923077,39,145,3.717948718,12,28,1.333333333,9,28,2.111111111,21,56,2.666666667,0,3,#DIV/0!
POA2466,312,617,1.977564103,76,316,2.157894737,38,112,1.947368421,114,428,3.754385965,45,131,1.911111111,30,60,1,75,191,2.546666667,3,10,3.333333333
POA2469,548,1071,1.954379562,248,1125,2.536290323,126,388,2.079365079,374,1513,4.045454545,115,380,2.304347826,84,191,1.273809524,199,571,2.869346734,26,52,2
POA2470,1618,3220,1.990111248,1069,4536,2.243217961,424,1370,2.231132075,1493,5906,3.955793704,498,1570,2.152610442,303,669,1.207920792,801,2239,2.79525593,63,127,2.015873016
POA2471,275,547,1.989090909,188,829,2.409574468,83,282,2.397590361,271,1111,4.099630996,75,247,2.293333333,42,99,1.357142857,117,346,2.957264957,6,15,2.5
POA2472,203,412,2.02955665,124,511,2.120967742,53,162,2.056603774,177,673,3.802259887,45,135,2,46,90,0.956521739,91,225,2.472527473,5,9,1.8
POA2473,410,825,2.012195122,153,624,2.078431373,75,229,2.053333333,228,853,3.74122807,94,286,2.042553191,64,142,1.21875,158,428,2.708860759,13,21,1.615384615
POA2474,773,1530,1.979301423,446,1895,2.248878924,180,561,2.116666667,626,2456,3.923322684,175,496,1.834285714,147,320,1.176870748,322,816,2.534161491,25,53,2.12
POA2475,53,108,2.037735849,29,137,2.724137931,6,23,2.833333333,35,160,4.571428571,9,39,3.333333333,12,18,0.5,21,57,2.714285714,3,3,1
POA2476,110,221,2.009090909,71,318,2.478873239,40,119,1.975,111,437,3.936936937,32,105,2.28125,19,46,1.421052632,51,151,2.960784314,5,8,1.6
POA2477,1463,2901,1.982911825,831,3481,2.188929001,385,1207,2.135064935,1216,4688,3.855263158,296,848,1.864864865,218,466,1.137614679,514,1314,2.556420233,34,82,2.411764706
POA2478,3288,6508,1.979318735,1820,7399,2.065384615,784,2510,2.201530612,2604,9909,3.805299539,724,2017,1.785911602,653,1397,1.139356815,1377,3414,2.479302832,80,174,2.175
POA2479,480,937,1.952083333,405,1642,2.054320988,155,500,2.225806452,560,2142,3.825,117,285,1.435897436,77,170,1.207792208,194,455,2.345360825,8,11,1.375
POA2480,4570,9031,1.976148796,3206,13297,2.14753587,1317,4322,2.281700835,4523,17619,3.895423392,1453,4167,1.867859601,981,2117,1.158002039,2434,6284,2.581758422,165,349,2.115151515
POA2481,989,1939,1.960566229,649,2509,1.865947612,247,772,2.125506073,896,3281,3.661830357,276,693,1.510869565,249,517,1.076305221,525,1210,2.304761905,35,72,2.057142857
POA2482,511,1009,1.974559687,416,1680,2.038461538,158,501,2.170886076,574,2181,3.799651568,239,630,1.635983264,165,342,1.072727273,404,972,2.405940594,15,36,2.4
POA2483,1013,2009,1.983218164,741,2934,1.95951417,291,919,2.158075601,1032,3853,3.733527132,373,994,1.664879357,264,557,1.109848485,637,1551,2.434850863,32,66,2.0625
POA2484,1975,3899,1.974177215,1252,5255,2.197284345,603,1982,2.286898839,1855,7237,3.901347709,542,1614,1.977859779,435,935,1.149425287,977,2549,2.609007165,66,138,2.090909091
POA2485,1792,3542,1.9765625,600,2340,1.9,319,1026,2.21630094,919,3366,3.662676823,353,944,1.674220963,338,731,1.162721893,691,1675,2.424023155,62,131,2.112903226
POA2486,4019,7980,1.985568549,2017,8347,2.138324244,975,3215,2.297435897,2992,11562,3.864304813,811,2431,1.997533909,708,1580,1.231638418,1519,4011,2.640552995,105,220,2.095238095
POA2487,1314,2586,1.96803653,812,3298,2.061576355,305,997,2.268852459,1117,4295,3.845120859,303,841,1.775577558,234,523,1.235042735,537,1364,2.540037244,37,72,1.945945946
POA2488,302,604,2,267,1054,1.947565543,91,283,2.10989011,358,1337,3.734636872,126,341,1.706349206,74,177,1.391891892,200,518,2.59,14,23,1.642857143
POA2489,783,1540,1.966794381,574,2328,2.055749129,125,400,2.2,699,2728,3.902718169,185,566,2.059459459,107,237,1.214953271,292,803,2.75,9,13,1.444444444
POA2490,71,138,1.943661972,61,223,1.655737705,32,109,2.40625,93,332,3.569892473,11,51,3.636363636,12,26,1.166666667,23,77,3.347826087,0,0,#DIV/0!
POA2500,3828,7569,1.977272727,2203,8722,1.959146618,1009,3384,2.353815659,3212,12106,3.768991283,687,1823,1.65356623,734,1653,1.252043597,1421,3476,2.446164673,232,482,2.077586207
POA2502,1099,2216,2.016378526,741,3114,2.20242915,476,1624,2.411764706,1217,4738,3.893179951,373,1168,2.131367292,404,933,1.309405941,777,2101,2.703989704,71,147,2.070422535
POA2505,474,939,1.981012658,298,1186,1.979865772,232,797,2.435344828,530,1983,3.741509434,161,444,1.757763975,149,342,1.295302013,310,786,2.535483871,20,43,2.15
POA2506,639,1294,2.025039124,520,2173,2.178846154,353,1245,2.526912181,873,3418,3.915234822,234,710,2.034188034,247,566,1.291497976,481,1276,2.652806653,24,53,2.208333333
POA2508,658,1310,1.990881459,947,3856,2.071805702,401,1422,2.546134663,1348,5278,3.915430267,137,394,1.875912409,144,320,1.222222222,281,714,2.540925267,18,34,1.888888889
POA2515,1003,1962,1.956131605,981,4001,2.078491335,435,1462,2.36091954,1416,5463,3.858050847,175,479,1.737142857,200,438,1.19,375,917,2.445333333,27,49,1.814814815
POA2516,490,983,2.006122449,537,2203,2.102420857,238,808,2.394957983,775,3011,3.88516129,133,384,1.887218045,144,319,1.215277778,277,703,2.537906137,17,34,2
POA2517,1273,2537,1.992930086,1126,4556,2.046181172,497,1707,2.434607646,1623,6263,3.858903266,278,787,1.830935252,341,773,1.26686217,619,1560,2.520193861,49,103,2.102040816
POA2518,1803,3591,1.991680532,1337,5476,2.095736724,681,2339,2.434654919,2018,7815,3.872646184,550,1567,1.849090909,536,1192,1.223880597,1086,2759,2.540515654,86,179,2.081395349
POA2519,1667,3321,1.99220156,1195,4863,2.069456067,703,2358,2.354196302,1898,7221,3.804531085,332,939,1.828313253,412,909,1.20631068,744,1848,2.483870968,71,144,2.028169014
POA2525,1094,2157,1.97166362,973,4021,2.132579651,507,1729,2.41025641,1480,5750,3.885135135,178,498,1.797752809,191,441,1.308900524,369,939,2.544715447,23,49,2.130434783
POA2526,1373,2711,1.974508376,1435,5975,2.163763066,848,2938,2.464622642,2283,8913,3.904073587,342,1039,2.038011696,303,685,1.260726073,645,1724,2.672868217,56,122,2.178571429
POA2527,1835,3654,1.991280654,1950,8169,2.189230769,914,3124,2.417943107,2864,11293,3.943086592,583,1760,2.018867925,408,925,1.267156863,991,2685,2.70938446,43,92,2.139534884
POA2528,2484,4995,2.010869565,1439,5974,2.151494093,959,3214,2.351407716,2398,9188,3.831526272,783,2384,2.044699872,707,1599,1.261669024,1490,3983,2.673154362,117,249,2.128205128
POA2529,2148,4285,1.994878957,2136,8891,2.162453184,1060,3623,2.417924528,3196,12514,3.915519399,574,1636,1.850174216,402,893,1.221393035,976,2529,2.591188525,68,144,2.117647059
POA2530,3011,6002,1.993357688,2504,10335,2.127396166,1313,4418,2.364813404,3817,14753,3.865077286,812,2488,2.064039409,643,1474,1.292379471,1455,3962,2.723024055,111,223,2.009009009
POA2533,1955,3834,1.96112532,1098,4519,2.115664845,731,2442,2.340629275,1829,6961,3.805904866,281,803,1.857651246,281,610,1.170818505,562,1413,2.514234875,34,68,2
POA2534,575,1135,1.973913043,397,1683,2.23929471,200,690,2.45,597,2373,3.974874372,78,231,1.961538462,82,182,1.219512195,160,413,2.58125,6,14,2.333333333
POA2535,1159,2291,1.976704055,427,1746,2.088992974,223,718,2.219730942,650,2464,3.790769231,115,321,1.791304348,101,216,1.138613861,216,537,2.486111111,15,33,2.2
POA2536,2505,4922,1.964870259,997,4163,2.17552658,460,1483,2.223913043,1457,5646,3.875085793,493,1503,2.048681542,298,637,1.137583893,791,2140,2.705436157,42,90,2.142857143
POA2537,1609,3161,1.96457427,662,2704,2.084592145,300,934,2.113333333,962,3638,3.781704782,302,868,1.874172185,226,485,1.146017699,528,1353,2.5625,32,60,1.875
POA2538,277,544,1.963898917,155,630,2.064516129,74,235,2.175675676,229,865,3.777292576,44,125,1.840909091,40,88,1.2,84,213,2.535714286,8,19,2.375
POA2539,2455,4846,1.973930754,990,4070,2.111111111,481,1535,2.191268191,1471,5605,3.810333107,459,1311,1.85620915,351,741,1.111111111,810,2052,2.533333333,44,91,2.068181818
POA2540,5469,10823,1.97897239,2760,11442,2.145652174,1253,4050,2.232242618,4013,15492,3.860453526,1087,3284,2.021159154,806,1703,1.112903226,1893,4987,2.634442684,115,247,2.147826087
POA2541,2567,5082,1.979742891,1516,6240,2.116094987,717,2397,2.343096234,2233,8637,3.86789073,867,2506,1.890426759,544,1223,1.248161765,1411,3729,2.64280652,91,189,2.076923077
POA2545,158,315,1.993670886,67,274,2.089552239,31,103,2.322580645,98,377,3.846938776,26,72,1.769230769,18,31,0.722222222,44,103,2.340909091,4,12,3
POA2546,1459,2877,1.971898561,438,1815,2.143835616,221,668,2.022624434,659,2483,3.767830046,190,560,1.947368421,139,296,1.129496403,329,856,2.601823708,25,56,2.24
POA2548,1181,2310,1.955969517,359,1474,2.105849582,168,527,2.136904762,527,2001,3.796963947,140,383,1.735714286,105,224,1.133333333,245,607,2.47755102,13,29,2.230769231
POA2549,482,948,1.966804979,286,1182,2.132867133,124,381,2.072580645,410,1563,3.812195122,83,245,1.951807229,60,126,1.1,143,371,2.594405594,5,6,1.2
POA2550,1998,3917,1.96046046,1184,4905,2.142736486,481,1515,2.14968815,1665,6420,3.855855856,377,1108,1.938992042,276,583,1.112318841,653,1691,2.589586524,36,69,1.916666667
POA2551,482,945,1.960580913,191,756,1.958115183,86,266,2.093023256,277,1022,3.689530686,121,371,2.066115702,71,150,1.112676056,192,521,2.713541667,16,32,2
POA2555,30,62,2.066666667,32,152,2.75,19,61,2.210526316,51,213,4.176470588,6,38,5.333333333,16,31,0.9375,22,69,3.136363636,0,4,#DIV/0!
POA2556,192,391,2.036458333,201,898,2.467661692,144,520,2.611111111,345,1418,4.110144928,33,115,2.484848485,42,101,1.404761905,75,216,2.88,3,7,2.333333333
POA2557,303,619,2.04290429,317,1440,2.542586751,251,932,2.71314741,568,2372,4.176056338,68,218,2.205882353,61,161,1.639344262,129,379,2.937984496,7,22,3.142857143
POA2558,694,1395,2.010086455,994,4184,2.209255533,664,2404,2.620481928,1658,6588,3.973462002,330,1024,2.103030303,266,637,1.394736842,596,1661,2.786912752,35,72,2.057142857
POA2559,87,170,1.954022989,219,1121,3.118721461,74,278,2.756756757,293,1399,4.774744027,332,1166,2.512048193,96,249,1.59375,428,1415,3.306074766,8,21,2.625
POA2560,5717,11502,2.01189435,5657,24394,2.3121796,3375,11788,2.492740741,9032,36182,4.005978742,2414,7538,2.122618061,1923,4489,1.334373375,4337,12027,2.773115056,301,635,2.109634551
POA2563,22,45,2.045454545,15,59,1.933333333,15,62,3.133333333,30,121,4.033333333,3,13,3.333333333,11,23,1.090909091,14,36,2.571428571,0,4,#DIV/0!
POA2564,877,1778,2.027366021,1080,4641,2.297222222,571,2035,2.563922942,1651,6676,4.043609933,522,1711,2.277777778,448,1068,1.383928571,970,2779,2.864948454,75,166,2.213333333
POA2565,1292,2623,2.030185759,1386,5744,2.144300144,896,3161,2.527901786,2282,8905,3.902278703,423,1242,1.936170213,410,956,1.331707317,833,2198,2.638655462,73,144,1.97260274
POA2566,1691,3406,2.014192785,2154,9149,2.247446611,1318,4646,2.525037936,3472,13795,3.973214286,674,2106,2.12462908,610,1452,1.380327869,1284,3558,2.771028037,101,230,2.277227723
POA2567,2440,4871,1.996311475,4032,16820,2.171626984,1459,5127,2.51405072,5491,21947,3.996904025,787,2436,2.095298602,541,1293,1.390018484,1328,3729,2.807981928,94,193,2.053191489
POA2568,100,209,2.09,68,307,2.514705882,44,162,2.681818182,112,469,4.1875,8,23,1.875,9,15,0.666666667,17,38,2.235294118,3,0,0
POA2569,116,231,1.99137931,115,489,2.252173913,80,263,2.2875,195,752,3.856410256,29,83,1.862068966,16,33,1.0625,45,116,2.577777778,4,9,2.25
POA2570,2772,5537,1.997474747,2597,11059,2.258375048,1352,4677,2.459319527,3949,15736,3.98480628,516,1533,1.970930233,494,1143,1.313765182,1010,2676,2.64950495,71,155,2.183098592
POA2571,918,1821,1.983660131,1040,4410,2.240384615,459,1554,2.385620915,1499,5964,3.978652435,196,577,1.943877551,150,337,1.246666667,346,914,2.641618497,30,64,2.133333333
POA2572,374,746,1.994652406,346,1454,2.202312139,169,569,2.366863905,515,2023,3.92815534,74,240,2.243243243,78,176,1.256410256,152,416,2.736842105,6,9,1.5
POA2573,420,836,1.99047619,358,1473,2.11452514,178,616,2.460674157,536,2089,3.89738806,152,495,2.256578947,136,313,1.301470588,288,808,2.805555556,19,41,2.157894737
POA2574,529,1060,2.003780718,501,2173,2.337325349,245,837,2.416326531,746,3010,4.034852547,105,341,2.247619048,95,204,1.147368421,200,545,2.725,11,26,2.363636364
POA2575,1454,2862,1.968363136,1131,4749,2.198938992,501,1672,2.337325349,1632,6421,3.934436275,364,1057,1.903846154,295,634,1.149152542,659,1691,2.566009105,36,69,1.916666667
POA2576,1820,3575,1.964285714,897,3764,2.196209588,382,1246,2.261780105,1279,5010,3.917122752,227,664,1.925110132,219,472,1.155251142,446,1136,2.547085202,36,75,2.083333333
POA2577,1837,3640,1.981491562,1101,4611,2.188010899,480,1579,2.289583333,1581,6190,3.915243517,331,963,1.909365559,264,593,1.246212121,595,1556,2.61512605,51,101,1.980392157
POA2578,368,714,1.940217391,133,560,2.210526316,67,210,2.134328358,200,770,3.85,58,173,1.982758621,37,71,0.918918919,95,244,2.568421053,3,9,3
POA2579,491,945,1.924643585,266,1156,2.345864662,114,359,2.149122807,380,1515,3.986842105,80,243,2.0375,48,104,1.166666667,128,347,2.7109375,7,21,3
POA2580,2904,5725,1.971418733,1954,8108,2.149437052,896,2905,2.2421875,2850,11013,3.864210526,768,2176,1.833333333,532,1145,1.152255639,1300,3321,2.554615385,105,226,2.152380952
POA2581,262,505,1.927480916,171,678,1.964912281,67,215,2.208955224,238,893,3.75210084,36,100,1.777777778,31,68,1.193548387,67,168,2.507462687,3,11,3.666666667
POA2582,1320,2593,1.964393939,1089,4523,2.153351699,378,1237,2.272486772,1467,5760,3.926380368,186,520,1.795698925,166,364,1.192771084,352,884,2.511363636,17,38,2.235294118
POA2583,554,1090,1.967509025,280,1181,2.217857143,146,468,2.205479452,426,1649,3.870892019,66,183,1.772727273,73,157,1.150684932,139,340,2.446043165,19,40,2.105263158
POA2584,69,134,1.942028986,35,132,1.771428571,16,48,2,51,180,3.529411765,7,29,3.142857143,9,11,0.222222222,16,40,2.5,0,0,#DIV/0!
POA2585,33,68,2.060606061,28,111,1.964285714,8,19,1.375,36,130,3.611111111,4,5,0.25,3,4,0.333333333,7,9,1.285714286,0,3,#DIV/0!
POA2586,345,667,1.933333333,199,854,2.291457286,86,265,2.081395349,285,1119,3.926315789,55,175,2.181818182,45,100,1.222222222,100,275,2.75,8,16,2
POA2587,393,776,1.974554707,199,844,2.24120603,68,210,2.088235294,267,1054,3.947565543,66,205,2.106060606,54,113,1.092592593,120,318,2.65,14,21,1.5
POA2588,36,74,2.055555556,25,100,2,9,23,1.555555556,34,123,3.617647059,3,20,5.666666667,5,12,1.4,8,32,4,0,3,#DIV/0!
POA2590,970,1892,1.950515464,490,2061,2.206122449,197,626,2.177664975,687,2687,3.911208151,177,517,1.920903955,116,247,1.129310345,293,764,2.607508532,19,44,2.315789474
POA2594,1184,2339,1.975506757,936,3961,2.231837607,325,1032,2.175384615,1261,4993,3.959555908,329,979,1.975683891,188,408,1.170212766,517,1387,2.6827853,44,90,2.045454545
POA2618,159,308,1.937106918,130,568,2.369230769,74,226,2.054054054,204,794,3.892156863,16,38,1.375,16,35,1.1875,32,73,2.28125,0,3,#DIV/0!
POA2619,741,1461,1.971659919,1242,5057,2.071658615,378,1294,2.423280423,1620,6351,3.92037037,136,357,1.625,111,260,1.342342342,247,617,2.497975709,19,44,2.315789474
POA2620,3505,6948,1.982310984,2836,11495,2.053244006,1419,4753,2.349541931,4255,16248,3.818566392,818,2296,1.806845966,704,1570,1.230113636,1522,3866,2.540078844,167,346,2.071856287
POA2621,580,1144,1.972413793,578,2341,2.05017301,218,720,2.302752294,796,3061,3.845477387,84,241,1.869047619,51,112,1.196078431,135,353,2.614814815,7,15,2.142857143
POA2622,425,833,1.96,236,959,2.063559322,80,254,2.175,316,1213,3.838607595,66,190,1.878787879,50,111,1.22,116,301,2.594827586,4,12,3
POA2623,81,158,1.950617284,61,257,2.213114754,18,55,2.055555556,79,312,3.949367089,18,43,1.388888889,15,28,0.866666667,33,71,2.151515152,0,5,#DIV/0!
POA2625,7,23,3.285714286,16,45,0.8125,3,13,3.333333333,19,58,3.052631579,3,0,-1,0,0,#DIV/0!,3,0,0,0,0,#DIV/0!
POA2626,54,100,1.851851852,46,207,2.5,23,65,1.826086957,69,272,3.942028986,4,14,2.5,5,14,1.8,9,28,3.111111111,0,4,#DIV/0!
POA2627,351,687,1.957264957,343,1367,1.985422741,82,274,2.341463415,425,1641,3.861176471,57,144,1.526315789,46,103,1.239130435,103,247,2.398058252,8,15,1.875
POA2628,215,420,1.953488372,154,610,1.961038961,58,176,2.034482759,212,786,3.70754717,38,98,1.578947368,26,54,1.076923077,64,152,2.375,6,13,2.166666667
POA2629,106,198,1.867924528,35,141,2.028571429,12,37,2.083333333,47,178,3.787234043,5,16,2.2,7,23,2.285714286,12,39,3.25,0,4,#DIV/0!
POA2630,1005,1981,1.971144279,592,2458,2.152027027,223,698,2.130044843,815,3156,3.872392638,217,615,1.834101382,143,297,1.076923077,360,912,2.533333333,27,51,1.888888889
POA2631,105,201,1.914285714,57,251,2.403508772,18,50,1.777777778,75,301,4.013333333,11,37,2.363636364,12,29,1.416666667,23,66,2.869565217,3,3,1
POA2632,220,428,1.945454545,128,516,2.03125,35,107,2.057142857,163,623,3.82208589,33,102,2.090909091,34,67,0.970588235,67,169,2.52238806,5,15,3
POA2633,64,127,1.984375,33,118,1.575757576,7,33,3.714285714,40,151,3.775,7,25,2.571428571,12,16,0.333333333,19,41,2.157894737,0,0,#DIV/0!
POA2640,3438,6748,1.962769052,2687,10986,2.088574619,980,3191,2.256122449,3667,14177,3.866103082,806,2329,1.889578164,600,1321,1.201666667,1406,3650,2.59601707,112,233,2.080357143
POA2641,1530,3032,1.981699346,934,3823,2.093147752,421,1400,2.325415677,1355,5223,3.854612546,476,1420,1.983193277,328,726,1.213414634,804,2146,2.669154229,63,131,2.079365079
POA2642,566,1117,1.973498233,444,1928,2.342342342,206,653,2.169902913,650,2581,3.970769231,73,239,2.273972603,73,164,1.246575342,146,403,2.760273973,11,20,1.818181818
POA2643,358,710,1.983240223,203,811,1.995073892,71,234,2.295774648,274,1045,3.813868613,61,164,1.68852459,35,84,1.4,96,248,2.583333333,11,20,1.818181818
POA2644,317,626,1.974763407,210,896,2.266666667,88,264,2,298,1160,3.89261745,54,150,1.777777778,31,64,1.064516129,85,214,2.517647059,3,10,3.333333333
POA2645,51,100,1.960784314,15,71,2.733333333,7,20,1.857142857,22,91,4.136363636,3,7,1.333333333,3,13,3.333333333,6,20,3.333333333,0,3,#DIV/0!
POA2646,918,1808,1.969498911,498,2080,2.176706827,170,546,2.211764706,668,2626,3.931137725,165,507,2.072727273,83,184,1.21686747,248,691,2.786290323,12,25,2.083333333
POA2647,331,655,1.978851964,120,512,2.266666667,36,118,2.277777778,156,630,4.038461538,27,68,1.518518519,27,54,1,54,122,2.259259259,6,14,2.333333333
POA2648,340,671,1.973529412,138,576,2.173913043,73,219,2,211,795,3.767772512,54,153,1.833333333,47,103,1.191489362,101,256,2.534653465,9,16,1.777777778
POA2649,3,3,1,0,0,#DIV/0!,0,0,#DIV/0!,0,0,#DIV/0!,0,4,#DIV/0!,0,0,#DIV/0!,0,4,#DIV/0!,0,0,#DIV/0!
POA2650,5479,10797,1.970615076,4417,18520,2.192891103,1556,5133,2.298843188,5973,23653,3.959986606,1493,4414,1.956463496,971,2130,1.19361483,2464,6544,2.655844156,257,524,2.038910506
POA2651,156,301,1.929487179,183,733,2.005464481,51,167,2.274509804,234,900,3.846153846,50,166,2.32,31,67,1.161290323,81,233,2.87654321,4,9,2.25
POA2652,613,1209,1.972267537,399,1696,2.250626566,182,589,2.236263736,581,2285,3.932874355,95,295,2.105263158,73,161,1.205479452,168,456,2.714285714,16,29,1.8125
POA2653,302,592,1.960264901,160,689,2.30625,56,178,2.178571429,216,867,4.013888889,45,139,2.088888889,36,67,0.861111111,81,206,2.543209877,4,11,2.75
POA2655,117,233,1.991452991,89,373,2.191011236,38,117,2.078947368,127,490,3.858267717,20,56,1.8,22,45,1.045454545,42,101,2.404761905,3,9,3
POA2656,158,322,2.037974684,97,425,2.381443299,43,122,1.837209302,140,547,3.907142857,16,52,2.25,25,50,1,41,102,2.487804878,4,6,1.5
POA2658,167,326,1.952095808,110,490,2.454545455,40,118,1.95,150,608,4.053333333,32,92,1.875,15,34,1.266666667,47,126,2.680851064,3,9,3
POA2659,111,211,1.900900901,72,315,2.375,33,109,2.303030303,105,424,4.038095238,13,40,2.076923077,12,23,0.916666667,25,63,2.52,6,10,1.666666667
POA2660,201,392,1.950248756,122,544,2.459016393,40,118,1.95,162,662,4.086419753,44,145,2.295454545,27,56,1.074074074,71,201,2.830985915,3,10,3.333333333
POA2661,22,45,2.045454545,30,128,2.266666667,0,3,#DIV/0!,30,131,4.366666667,3,3,0,3,0,-1,6,3,0.5,0,0,#DIV/0!
POA2663,375,741,1.976,294,1301,2.425170068,122,402,2.295081967,416,1703,4.09375,121,358,1.958677686,71,156,1.197183099,192,514,2.677083333,14,20,1.428571429
POA2665,286,571,1.996503497,204,851,2.171568627,73,230,2.150684932,277,1081,3.902527076,38,122,2.210526316,22,53,1.409090909,60,175,2.916666667,9,17,1.888888889
POA2666,617,1225,1.98541329,368,1582,2.298913043,151,478,2.165562914,519,2060,3.969171484,120,359,1.991666667,91,203,1.230769231,211,562,2.663507109,14,28,2
POA2668,47,94,2,33,153,2.636363636,5,21,3.2,38,174,4.578947368,7,15,1.142857143,7,16,1.285714286,14,31,2.214285714,5,3,0.6
POA2669,232,460,1.982758621,179,784,2.379888268,72,216,2,251,1000,3.984063745,31,102,2.290322581,24,53,1.208333333,55,155,2.818181818,6,13,2.166666667
POA2671,497,974,1.959758551,315,1370,2.349206349,104,338,2.25,419,1708,4.076372315,72,204,1.833333333,53,116,1.188679245,125,320,2.56,8,16,2
POA2672,159,316,1.987421384,112,475,2.241071429,37,115,2.108108108,149,590,3.959731544,43,142,2.302325581,28,63,1.25,71,205,2.887323944,23,42,1.826086957
POA2675,174,338,1.942528736,111,447,2.027027027,37,116,2.135135135,148,563,3.804054054,24,79,2.291666667,22,44,1,46,123,2.673913043,3,9,3
POA2678,0,0,#DIV/0!,0,0,#DIV/0!,0,0,#DIV/0!,0,0,#DIV/0!,0,0,#DIV/0!,0,0,#DIV/0!,0,0,#DIV/0!,0,0,#DIV/0!
POA2680,2146,4287,1.997670084,1985,8509,2.286649874,795,2695,2.389937107,2780,11204,4.030215827,482,1466,2.041493776,364,833,1.288461538,846,2299,2.71749409,96,205,2.135416667
POA2681,167,334,2,155,653,2.212903226,56,199,2.553571429,211,852,4.037914692,27,84,2.111111111,18,47,1.611111111,45,131,2.911111111,10,14,1.4
POA2700,487,959,1.969199179,331,1426,2.3081571,141,437,2.09929078,472,1863,3.947033898,156,473,2.032051282,82,181,1.207317073,238,654,2.74789916,23,46,2
POA2701,293,582,1.986348123,202,901,2.46039604,76,246,2.236842105,278,1147,4.125899281,56,155,1.767857143,25,61,1.44,81,216,2.666666667,9,13,1.444444444
POA2702,75,147,1.96,41,200,2.87804878,17,49,1.882352941,58,249,4.293103448,15,56,2.733333333,4,11,1.75,19,67,3.526315789,4,4,1
POA2703,68,140,2.058823529,45,186,2.133333333,14,56,3,59,242,4.101694915,22,64,1.909090909,6,23,2.833333333,28,87,3.107142857,3,3,1
POA2705,951,1889,1.986330179,801,3425,2.275905119,336,1053,2.133928571,1137,4478,3.938434477,274,831,2.032846715,162,370,1.283950617,436,1201,2.754587156,34,76,2.235294118
POA2706,124,251,2.024193548,83,342,2.120481928,39,124,2.179487179,122,466,3.819672131,48,141,1.9375,21,46,1.19047619,69,187,2.710144928,10,17,1.7
POA2707,149,285,1.912751678,125,530,2.24,35,110,2.142857143,160,640,4,21,62,1.952380952,20,44,1.2,41,106,2.585365854,7,13,1.857142857
POA2710,1201,2357,1.962531224,695,2905,2.179856115,261,808,2.095785441,956,3713,3.883891213,256,775,2.02734375,183,397,1.169398907,439,1172,2.669703872,35,74,2.114285714
POA2711,363,706,1.944903581,259,1041,2.019305019,98,294,2,357,1335,3.739495798,74,258,2.486486486,60,127,1.116666667,134,385,2.873134328,15,28,1.866666667
POA2712,189,371,1.962962963,96,410,2.270833333,53,165,2.113207547,149,575,3.859060403,30,81,1.7,8,26,2.25,38,107,2.815789474,9,17,1.888888889
POA2713,401,785,1.957605985,211,948,2.492890995,77,253,2.285714286,288,1201,4.170138889,66,197,1.984848485,51,104,1.039215686,117,301,2.572649573,5,11,2.2
POA2714,393,759,1.93129771,124,496,2,57,172,2.01754386,181,668,3.690607735,45,126,1.8,25,54,1.16,70,180,2.571428571,9,23,2.555555556
POA2715,189,367,1.941798942,117,487,2.162393162,55,177,2.218181818,172,664,3.860465116,30,93,2.1,26,51,0.961538462,56,144,2.571428571,3,10,3.333333333
POA2716,130,256,1.969230769,74,303,2.094594595,37,110,1.972972973,111,413,3.720720721,16,57,2.5625,12,24,1,28,81,2.892857143,0,0,#DIV/0!
POA2717,170,334,1.964705882,105,477,2.542857143,40,138,2.45,145,615,4.24137931,43,141,2.279069767,26,55,1.115384615,69,196,2.84057971,3,13,4.333333333
POA2720,859,1699,1.977881257,611,2557,2.184942717,272,866,2.183823529,883,3423,3.876557191,187,546,1.919786096,138,298,1.15942029,325,844,2.596923077,26,51,1.961538462
POA2721,58,116,2,22,99,2.5,12,40,2.333333333,34,139,4.088235294,7,24,2.428571429,15,26,0.733333333,22,50,2.272727273,0,0,#DIV/0!
POA2722,340,674,1.982352941,239,1042,2.359832636,104,331,2.182692308,343,1373,4.002915452,66,215,2.257575758,46,91,0.97826087,112,306,2.732142857,10,28,2.8
POA2725,60,120,2,38,156,2.105263158,11,36,2.272727273,49,192,3.918367347,7,21,2,12,28,1.333333333,19,49,2.578947368,0,3,#DIV/0!
POA2726,47,92,1.957446809,28,123,2.392857143,6,21,2.5,34,144,4.235294118,4,11,1.75,3,0,-1,7,11,1.571428571,0,5,#DIV/0!
POA2727,77,147,1.909090909,60,253,2.216666667,10,33,2.3,70,286,4.085714286,5,24,3.8,6,10,0.666666667,11,34,3.090909091,0,0,#DIV/0!
POA2729,220,440,2,163,675,2.141104294,56,177,2.160714286,219,852,3.890410959,32,92,1.875,18,39,1.166666667,50,131,2.62,0,5,#DIV/0!
POA2730,194,381,1.963917526,94,409,2.35106383,34,108,2.176470588,128,517,4.0390625,31,85,1.741935484,29,57,0.965517241,60,142,2.366666667,5,12,2.4
POA2731,819,1606,1.960927961,392,1609,2.104591837,149,489,2.281879195,541,2098,3.878003697,104,297,1.855769231,63,133,1.111111111,167,430,2.574850299,11,22,2
POA2732,263,527,2.003802281,118,479,2.059322034,55,171,2.109090909,173,650,3.757225434,34,100,1.941176471,26,40,0.538461538,60,140,2.333333333,4,9,2.25
POA2733,81,165,2.037037037,50,193,1.86,12,38,2.166666667,62,231,3.725806452,15,43,1.866666667,7,18,1.571428571,22,61,2.772727273,0,0,#DIV/0!
POA2735,91,180,1.978021978,49,222,2.530612245,31,108,2.483870968,80,330,4.125,8,17,1.125,0,6,#DIV/0!,8,23,2.875,0,0,#DIV/0!
POA2736,65,136,2.092307692,24,94,1.916666667,11,36,2.272727273,35,130,3.714285714,3,5,0.666666667,9,13,0.444444444,12,18,1.5,4,4,1
POA2737,79,161,2.037974684,70,303,2.328571429,30,107,2.566666667,100,410,4.1,16,41,1.5625,10,17,0.7,26,58,2.230769231,7,8,1.142857143
POA2738,151,299,1.98013245,122,513,2.204918033,44,139,2.159090909,166,652,3.927710843,21,60,1.857142857,10,21,1.1,31,81,2.612903226,4,6,1.5
POA2739,172,345,2.005813953,142,574,2.042253521,42,148,2.523809524,184,722,3.923913043,32,92,1.875,23,46,1,55,138,2.509090909,3,5,1.666666667
POA2745,1964,3933,2.002545825,2955,12457,2.215566836,1301,4569,2.511913912,4256,17026,4.000469925,546,1615,1.957875458,384,902,1.348958333,930,2517,2.706451613,72,160,2.222222222
POA2747,2787,5616,2.015069968,2844,11845,2.164908579,1516,5274,2.478891821,4360,17119,3.926376147,1113,3324,1.986522911,882,2023,1.293650794,1995,5347,2.680200501,159,327,2.056603774
POA2748,140,285,2.035714286,173,792,2.578034682,123,450,2.658536585,296,1242,4.195945946,31,81,1.612903226,25,63,1.52,56,144,2.571428571,4,9,2.25
POA2749,1177,2365,2.009345794,1540,6463,2.196753247,734,2585,2.521798365,2274,9048,3.978891821,503,1572,2.125248509,348,810,1.327586207,851,2382,2.799059929,48,98,2.041666667
POA2750,4115,8237,2.001701094,3358,13781,2.103930911,1668,5653,2.389088729,5026,19434,3.866693195,1111,3215,1.893789379,1093,2486,1.274473925,2204,5701,2.586660617,197,398,2.020304569
POA2752,350,705,2.014285714,475,2043,2.301052632,258,909,2.523255814,733,2952,4.02728513,88,293,2.329545455,78,177,1.269230769,166,470,2.831325301,11,25,2.272727273
POA2753,1403,2794,1.9914469,1420,5978,2.209859155,693,2372,2.422799423,2113,8350,3.951727402,391,1167,1.984654731,376,846,1.25,767,2013,2.624511082,61,118,1.93442623
POA2754,537,1074,2,436,1822,2.178899083,227,773,2.405286344,663,2595,3.914027149,134,386,1.880597015,133,314,1.360902256,267,700,2.621722846,15,32,2.133333333
POA2756,2604,5200,1.996927803,3011,12551,2.168382597,1403,4849,2.45616536,4414,17400,3.942002719,895,2620,1.927374302,733,1699,1.31787176,1628,4319,2.652948403,88,188,2.136363636
POA2757,106,209,1.971698113,67,298,2.447761194,43,149,2.465116279,110,447,4.063636364,14,32,1.285714286,13,38,1.923076923,27,70,2.592592593,4,4,1
POA2758,845,1669,1.975147929,776,3377,2.351804124,449,1526,2.398663697,1225,4903,4.00244898,109,325,1.981651376,111,250,1.252252252,220,575,2.613636364,14,24,1.714285714
POA2759,1816,3664,2.017621145,2491,10553,2.236451224,1757,6275,2.571428571,4248,16828,3.961393597,622,1912,2.073954984,623,1512,1.426966292,1245,3424,2.750200803,71,151,2.126760563
POA2760,2117,4292,2.02739726,2042,8698,2.259549461,975,3369,2.455384615,3017,12067,3.999668545,1010,3106,2.075247525,888,2098,1.362612613,1898,5204,2.741833509,163,337,2.067484663
POA2761,1358,2748,2.023564065,3177,13604,2.28202707,1383,5063,2.66088214,4560,18667,4.093640351,729,2261,2.101508916,491,1210,1.464358452,1220,3471,2.845081967,65,151,2.323076923
POA2762,308,616,2,339,1442,2.253687316,197,692,2.512690355,536,2134,3.981343284,90,293,2.255555556,70,159,1.271428571,160,452,2.825,16,37,2.3125
POA2763,2059,4141,2.011170471,3412,13932,2.083235639,1454,5200,2.576341128,4866,19132,3.931771476,625,1923,2.0768,629,1522,1.419713831,1254,3445,2.747208931,74,163,2.202702703
POA2765,1254,2538,2.023923445,1136,4901,2.314260563,724,2553,2.526243094,1860,7454,4.007526882,330,990,2,316,720,1.278481013,646,1710,2.647058824,68,148,2.176470588
POA2766,892,1799,2.016816143,1339,5792,2.325616131,671,2432,2.624441133,2010,8224,4.091542289,356,1141,2.20505618,344,837,1.433139535,700,1978,2.825714286,62,137,2.209677419
POA2767,1187,2412,2.032013479,1732,7357,2.247690531,1108,4000,2.610108303,2840,11357,3.998943662,596,1937,2.25,560,1355,1.419642857,1156,3292,2.847750865,72,158,2.194444444
POA2768,1575,3180,2.019047619,3412,13998,2.102579132,1173,4227,2.603580563,4585,18225,3.974918212,396,1177,1.972222222,313,790,1.523961661,709,1967,2.774330042,53,126,2.377358491
POA2769,274,547,1.996350365,444,1735,1.907657658,80,289,2.6125,524,2024,3.86259542,28,74,1.642857143,32,77,1.40625,60,151,2.516666667,3,5,1.666666667
POA2770,3393,6900,2.033598585,4681,21191,2.52702414,2237,7900,2.531515422,6918,29091,4.205117086,2971,10179,2.426119152,1858,4439,1.389128095,4829,14618,3.02712777,325,706,2.172307692
POA2773,555,1093,1.969369369,575,2417,2.203478261,315,1085,2.444444444,890,3502,3.934831461,89,273,2.06741573,100,233,1.33,189,506,2.677248677,15,31,2.066666667
POA2774,1292,2566,1.986068111,1144,4731,2.13548951,685,2341,2.417518248,1829,7072,3.866593767,235,658,1.8,257,589,1.291828794,492,1247,2.534552846,27,54,2
POA2775,172,332,1.930232558,89,388,2.359550562,38,125,2.289473684,127,513,4.039370079,29,94,2.24137931,16,26,0.625,45,120,2.666666667,3,6,2
POA2776,397,785,1.977329975,365,1544,2.230136986,203,676,2.330049261,568,2220,3.908450704,85,252,1.964705882,78,171,1.192307692,163,423,2.595092025,13,16,1.230769231
POA2777,1768,3495,1.976809955,1617,6720,2.155844156,821,2738,2.334957369,2438,9458,3.879409352,313,916,1.926517572,373,807,1.163538874,686,1723,2.511661808,48,101,2.104166667
POA2778,268,532,1.985074627,235,965,2.106382979,92,307,2.336956522,327,1272,3.889908257,43,126,1.930232558,42,81,0.928571429,85,207,2.435294118,0,6,#DIV/0!
POA2779,427,853,1.99765808,442,1775,2.015837104,164,545,2.323170732,606,2320,3.828382838,121,356,1.94214876,86,177,1.058139535,207,533,2.574879227,9,24,2.666666667
POA2780,1278,2502,1.957746479,759,3045,2.011857708,285,922,2.235087719,1044,3967,3.799808429,345,965,1.797101449,301,653,1.169435216,646,1618,2.504643963,41,85,2.073170732
POA2782,745,1472,1.975838926,405,1641,2.051851852,178,562,2.157303371,583,2203,3.778730703,144,397,1.756944444,93,192,1.064516129,237,589,2.485232068,16,26,1.625
POA2783,267,528,1.97752809,223,927,2.156950673,108,354,2.277777778,331,1281,3.870090634,94,267,1.840425532,63,132,1.095238095,157,399,2.541401274,7,8,1.142857143
POA2784,124,238,1.919354839,109,438,2.018348624,42,143,2.404761905,151,581,3.847682119,28,80,1.857142857,19,37,0.947368421,47,117,2.489361702,0,3,#DIV/0!
POA2785,552,1077,1.951086957,264,1064,2.03030303,87,277,2.183908046,351,1341,3.820512821,112,299,1.669642857,106,220,1.075471698,218,519,2.380733945,10,19,1.9
POA2786,117,232,1.982905983,68,271,1.985294118,29,82,1.827586207,97,353,3.639175258,25,76,2.04,22,45,1.045454545,47,121,2.574468085,0,0,#DIV/0!
POA2787,488,967,1.981557377,323,1362,2.216718266,145,459,2.165517241,468,1821,3.891025641,95,305,2.210526316,64,146,1.28125,159,451,2.836477987,6,8,1.333333333
POA2790,1589,3135,1.972938955,997,4150,2.162487462,473,1560,2.298097252,1470,5710,3.884353741,405,1178,1.908641975,332,705,1.123493976,737,1883,2.55495251,64,134,2.09375
POA2791,78,153,1.961538462,60,265,2.416666667,22,79,2.590909091,82,344,4.195121951,10,43,3.3,10,24,1.4,20,67,3.35,3,3,1
POA2792,61,121,1.983606557,35,160,2.571428571,16,38,1.375,51,198,3.882352941,14,47,2.357142857,12,16,0.333333333,26,63,2.423076923,0,0,#DIV/0!
POA2793,178,356,2,66,268,2.060606061,35,113,2.228571429,101,381,3.772277228,21,59,1.80952381,22,49,1.227272727,43,108,2.511627907,5,11,2.2
POA2794,1185,2354,1.98649789,705,3010,2.269503546,295,938,2.179661017,1000,3948,3.948,236,759,2.216101695,153,351,1.294117647,389,1110,2.853470437,28,57,2.035714286
POA2795,3977,7856,1.97535831,3089,12987,2.204273228,1192,3910,2.280201342,4281,16897,3.946975006,1025,3047,1.972682927,638,1373,1.152037618,1663,4420,2.657847264,147,301,2.047619048
POA2797,33,63,1.909090909,10,33,1.3,6,21,2.5,16,54,3.375,9,23,1.555555556,6,11,0.833333333,15,34,2.266666667,3,6,2
POA2798,253,504,1.992094862,235,999,2.25106383,71,234,2.295774648,306,1233,4.029411765,36,109,2.027777778,36,74,1.055555556,72,183,2.541666667,10,15,1.5
POA2799,387,768,1.984496124,312,1334,2.275641026,132,433,2.28030303,444,1767,3.97972973,90,271,2.011111111,75,161,1.146666667,165,432,2.618181818,16,33,2.0625
POA2800,3983,7838,1.96786342,3432,14325,2.173951049,1237,4033,2.260307195,4669,18358,3.931891197,1108,3384,2.054151625,752,1646,1.188829787,1860,5030,2.704301075,151,312,2.066225166
POA2803,53,102,1.924528302,15,58,1.866666667,10,27,1.7,25,85,3.4,6,21,2.5,7,13,0.857142857,13,34,2.615384615,0,0,#DIV/0!
POA2804,313,616,1.968051118,187,822,2.395721925,76,230,2.026315789,263,1052,4,64,188,1.9375,56,123,1.196428571,120,311,2.591666667,10,26,2.6
POA2805,44,86,1.954545455,21,91,2.333333333,8,19,1.375,29,110,3.793103448,7,23,2.285714286,4,6,0.5,11,29,2.636363636,0,0,#DIV/0!
POA2806,124,248,2,63,249,1.952380952,33,94,1.848484848,96,343,3.572916667,20,57,1.85,9,22,1.444444444,29,79,2.724137931,0,3,#DIV/0!
POA2807,25,50,2,16,64,2,5,14,1.8,21,78,3.714285714,9,35,2.888888889,6,6,0,15,41,2.733333333,0,0,#DIV/0!
POA2808,38,80,2.105263158,9,35,1.888888889,9,18,1,18,53,2.944444444,3,7,1.333333333,0,4,#DIV/0!,3,11,3.666666667,0,3,#DIV/0!
POA2809,32,69,2.15625,25,96,1.84,13,37,1.846153846,38,133,3.5,6,21,2.5,7,12,0.714285714,13,33,2.538461538,4,3,0.75
POA2810,423,828,1.957446809,209,874,2.181818182,86,248,1.88372093,295,1122,3.803389831,64,176,1.75,46,103,1.239130435,110,279,2.536363636,14,27,1.928571429
POA2820,807,1606,1.990086741,520,2191,2.213461538,194,609,2.139175258,714,2800,3.921568627,269,847,2.148698885,135,302,1.237037037,404,1149,2.844059406,46,92,2
POA2821,506,984,1.944664032,371,1577,2.250673854,139,430,2.09352518,510,2007,3.935294118,177,570,2.220338983,90,195,1.166666667,267,765,2.865168539,21,38,1.80952381
POA2823,159,314,1.974842767,99,429,2.333333333,32,96,2,131,525,4.007633588,55,192,2.490909091,17,34,1,72,226,3.138888889,9,18,2
POA2824,267,524,1.962546816,173,691,1.994219653,66,209,2.166666667,239,900,3.765690377,68,229,2.367647059,44,89,1.022727273,112,318,2.839285714,8,19,2.375
POA2825,248,497,2.004032258,228,941,2.127192982,67,205,2.059701493,295,1146,3.884745763,71,236,2.323943662,45,86,0.911111111,116,322,2.775862069,10,21,2.1
POA2827,420,821,1.954761905,228,934,2.096491228,111,347,2.126126126,339,1281,3.778761062,119,374,2.142857143,65,137,1.107692308,184,511,2.777173913,15,28,1.866666667
POA2828,68,139,2.044117647,29,131,2.517241379,19,46,1.421052632,48,177,3.6875,23,69,2,22,44,1,45,113,2.511111111,5,11,2.2
POA2829,346,685,1.979768786,195,810,2.153846154,83,260,2.13253012,278,1070,3.848920863,121,422,2.487603306,60,139,1.316666667,181,561,3.099447514,23,43,1.869565217
POA2830,3701,7291,1.970008106,3043,12659,2.160039435,1131,3609,2.190981432,4174,16268,3.89746047,1250,3825,2.06,679,1505,1.216494845,1929,5330,2.763089684,148,307,2.074324324
POA2831,438,852,1.945205479,325,1350,2.153846154,120,341,1.841666667,445,1691,3.8,89,274,2.078651685,57,126,1.210526316,146,400,2.739726027,23,52,2.260869565
POA2832,232,459,1.978448276,177,731,2.129943503,64,204,2.1875,241,935,3.87966805,113,390,2.451327434,52,124,1.384615385,165,514,3.115151515,15,40,2.666666667
POA2833,74,154,2.081081081,52,228,2.384615385,19,62,2.263157895,71,290,4.084507042,19,63,2.315789474,12,23,0.916666667,31,86,2.774193548,3,9,3
POA2834,237,467,1.970464135,120,500,2.166666667,49,143,1.918367347,169,643,3.804733728,84,259,2.083333333,51,103,1.019607843,135,362,2.681481481,13,27,2.076923077
POA2835,438,861,1.965753425,358,1443,2.030726257,97,308,2.175257732,455,1751,3.848351648,89,237,1.662921348,65,136,1.092307692,154,373,2.422077922,18,38,2.111111111
POA2836,79,150,1.898734177,66,314,2.757575758,15,36,1.4,81,350,4.320987654,34,143,3.205882353,25,58,1.32,59,201,3.406779661,3,9,3
POA2839,93,182,1.956989247,91,396,2.351648352,30,92,2.066666667,121,488,4.033057851,66,232,2.515151515,30,79,1.633333333,96,311,3.239583333,14,27,1.928571429
POA2840,242,478,1.975206612,205,841,2.102439024,53,162,2.056603774,258,1003,3.887596899,86,273,2.174418605,39,87,1.230769231,125,360,2.88,17,39,2.294117647
POA2842,64,127,1.984375,23,108,2.695652174,14,40,1.857142857,37,148,4,16,55,2.4375,12,24,1,28,79,2.821428571,0,4,#DIV/0!
POA2843,139,281,2.021582734,117,470,2.017094017,23,76,2.304347826,140,546,3.9,31,81,1.612903226,13,23,0.769230769,44,104,2.363636364,5,6,1.2
POA2844,189,372,1.968253968,97,428,2.412371134,35,113,2.228571429,132,541,4.098484848,29,87,2,17,35,1.058823529,46,122,2.652173913,3,12,4
POA2845,198,382,1.929292929,166,686,2.13253012,61,212,2.475409836,227,898,3.955947137,57,170,1.98245614,23,61,1.652173913,80,231,2.8875,13,19,1.461538462
POA2846,48,93,1.9375,17,72,2.235294118,13,44,2.384615385,30,116,3.866666667,11,35,2.181818182,7,11,0.571428571,18,46,2.555555556,0,6,#DIV/0!
POA2847,276,556,2.014492754,162,686,2.234567901,72,241,2.347222222,234,927,3.961538462,63,196,2.111111111,49,109,1.224489796,112,305,2.723214286,16,37,2.3125
POA2848,192,381,1.984375,122,491,2.024590164,40,139,2.475,162,630,3.888888889,61,176,1.885245902,35,70,1,96,246,2.5625,6,16,2.666666667
POA2849,230,458,1.991304348,117,489,2.179487179,43,125,1.906976744,160,614,3.8375,22,65,1.954545455,28,51,0.821428571,50,116,2.32,0,0,#DIV/0!
POA2850,1832,3599,1.964519651,1245,5129,2.119678715,488,1549,2.174180328,1733,6678,3.853433353,377,1084,1.875331565,246,519,1.109756098,623,1603,2.573033708,57,121,2.122807018
POA2852,382,753,1.971204188,281,1165,2.145907473,107,338,2.158878505,388,1503,3.87371134,87,232,1.666666667,52,116,1.230769231,139,348,2.503597122,5,11,2.2
POA2864,133,268,2.015037594,110,465,2.227272727,50,167,2.34,160,632,3.95,19,48,1.526315789,20,32,0.6,39,80,2.051282051,0,4,#DIV/0!
POA2865,92,178,1.934782609,61,257,2.213114754,20,65,2.25,81,322,3.975308642,16,51,2.1875,4,13,2.25,20,64,3.2,0,3,#DIV/0!
POA2866,334,657,1.967065868,256,1083,2.23046875,72,237,2.291666667,328,1320,4.024390244,55,175,2.181818182,43,94,1.186046512,98,269,2.744897959,13,27,2.076923077
POA2867,86,164,1.906976744,51,202,1.960784314,20,63,2.15,71,265,3.732394366,18,64,2.555555556,4,13,2.25,22,77,3.5,0,0,#DIV/0!
POA2868,53,107,2.018867925,35,167,2.771428571,11,46,3.181818182,46,213,4.630434783,17,48,1.823529412,10,19,0.9,27,67,2.481481481,3,0,0
POA2869,186,359,1.930107527,78,350,2.487179487,44,148,2.363636364,122,498,4.081967213,54,165,2.055555556,32,75,1.34375,86,240,2.790697674,5,13,2.6
POA2870,1236,2428,1.964401294,962,4161,2.325363825,349,1116,2.197707736,1311,5277,4.025171625,353,1054,1.985835694,220,461,1.095454545,573,1515,2.643979058,35,73,2.085714286
POA2871,1053,2086,1.981006648,646,2744,2.247678019,220,676,2.072727273,866,3420,3.949191686,247,766,2.101214575,152,321,1.111842105,399,1087,2.724310777,36,81,2.25
POA2873,98,195,1.989795918,46,185,2.02173913,12,38,2.166666667,58,223,3.844827586,15,37,1.466666667,11,22,1,26,59,2.269230769,3,0,0
POA2874,49,98,2,39,144,1.692307692,5,14,1.8,44,158,3.590909091,7,22,2.142857143,4,11,1.75,11,33,3,4,4,1
POA2875,143,280,1.958041958,85,352,2.141176471,28,90,2.214285714,113,442,3.911504425,18,51,1.833333333,18,39,1.166666667,36,90,2.5,0,4,#DIV/0!
POA2876,28,60,2.142857143,18,89,2.944444444,9,28,2.111111111,27,117,4.333333333,16,43,1.6875,6,13,1.166666667,22,56,2.545454545,0,0,#DIV/0!
POA2877,437,862,1.972540046,327,1356,2.146788991,114,361,2.166666667,441,1717,3.893424036,125,392,2.136,67,143,1.134328358,192,535,2.786458333,20,48,2.4
POA2878,17,30,1.764705882,12,41,1.416666667,0,3,#DIV/0!,12,44,3.666666667,7,26,2.714285714,5,8,0.6,12,34,2.833333333,0,3,#DIV/0!
POA2879,96,198,2.0625,46,182,1.956521739,20,64,2.2,66,246,3.727272727,22,75,2.409090909,22,48,1.181818182,44,123,2.795454545,12,13,1.083333333
POA2880,2178,4289,1.969237833,1169,4731,2.04704876,555,1728,2.113513514,1724,6459,3.746519722,661,1935,1.927382753,403,880,1.183622829,1064,2815,2.645676692,74,152,2.054054054
POA2898,43,80,1.860465116,30,99,1.3,8,20,1.5,38,119,3.131578947,3,9,2,7,9,0.285714286,10,18,1.8,0,0,#DIV/0!
POA3000,2217,4389,1.9797023,379,1234,1.255936675,110,336,2.054545455,489,1570,3.210633947,89,209,1.348314607,214,456,1.130841121,303,665,2.194719472,697,1500,2.152080344
POA3002,742,1439,1.9393531,127,452,1.559055118,87,261,2,214,713,3.331775701,22,52,1.363636364,34,72,1.117647059,56,124,2.214285714,29,64,2.206896552
POA3003,422,835,1.978672986,131,468,1.572519084,45,129,1.866666667,176,597,3.392045455,31,77,1.483870968,38,83,1.184210526,69,160,2.31884058,60,130,2.166666667
POA3004,1310,2558,1.952671756,243,826,1.399176955,129,385,1.984496124,372,1211,3.255376344,56,137,1.446428571,99,204,1.060606061,155,341,2.2,116,244,2.103448276
POA3005,91,170,1.868131868,14,61,2.357142857,6,9,0.5,20,70,3.5,3,3,0,4,10,1.5,7,13,1.857142857,10,25,2.5
POA3006,1578,3114,1.97338403,306,988,1.22875817,149,445,1.986577181,455,1433,3.149450549,65,164,1.523076923,119,257,1.159663866,184,421,2.288043478,301,648,2.15282392
POA3008,815,1584,1.943558282,152,494,1.25,91,290,2.186813187,243,784,3.226337449,30,75,1.5,65,137,1.107692308,95,212,2.231578947,60,130,2.166666667
POA3010,6,12,2,8,34,2.25,3,6,1,11,40,3.636363636,0,0,#DIV/0!,4,5,0.25,4,5,1.25,0,0,#DIV/0!
POA3011,1732,3447,1.990184758,1185,4421,1.730801688,395,1380,2.493670886,1580,5801,3.671518987,278,759,1.730215827,358,815,1.276536313,636,1574,2.474842767,168,359,2.136904762
POA3012,2125,4268,2.008470588,1796,6957,1.873608018,586,2076,2.542662116,2382,9033,3.792191436,482,1407,1.919087137,565,1295,1.292035398,1047,2702,2.580706781,163,355,2.17791411
POA3013,1426,2824,1.980364656,1273,4804,1.773762765,388,1321,2.404639175,1661,6125,3.687537628,218,590,1.706422018,313,713,1.277955272,531,1303,2.45386064,81,170,2.098765432
POA3015,1538,3044,1.979193758,1515,5853,1.863366337,514,1803,2.507782101,2029,7656,3.773287334,252,647,1.567460317,363,810,1.231404959,615,1457,2.369105691,104,210,2.019230769
POA3016,1291,2531,1.96049574,1421,5644,1.971850809,614,2162,2.521172638,2035,7806,3.835872236,233,656,1.815450644,289,640,1.214532872,522,1296,2.482758621,59,120,2.033898305
POA3018,1456,2913,2.000686813,820,3218,1.924390244,486,1662,2.419753086,1306,4880,3.736600306,192,520,1.708333333,310,690,1.225806452,502,1210,2.410358566,62,136,2.193548387
POA3019,485,1013,2.088659794,541,2331,2.308687616,265,982,2.705660377,806,3313,4.110421836,292,967,2.311643836,268,671,1.503731343,560,1638,2.925,79,177,2.240506329
POA3020,3278,6668,2.034167175,2777,11608,2.180050414,1780,6285,2.530898876,4557,17893,3.926486724,1078,3435,2.186456401,1242,3007,1.421095008,2320,6442,2.776724138,346,792,2.289017341
POA3021,4039,8291,2.052735826,3522,14786,2.198182851,2614,9179,2.511476664,6136,23965,3.905638853,1583,5104,2.224257738,1654,3981,1.406892382,3237,9085,2.80661106,362,824,2.276243094
POA3022,243,502,2.065843621,166,693,2.174698795,95,318,2.347368421,261,1011,3.873563218,82,265,2.231707317,81,197,1.432098765,163,462,2.834355828,27,60,2.222222222
POA3023,3895,7916,2.032349166,6114,24718,2.04285247,2191,7787,2.554084893,8305,32505,3.913907285,1432,4443,2.102653631,993,2430,1.447129909,2425,6873,2.834226804,228,504,2.210526316
POA3024,1515,3042,2.007920792,1856,7542,2.063577586,518,1767,2.411196911,2374,9309,3.921229992,602,1887,2.134551495,334,786,1.353293413,936,2673,2.855769231,75,161,2.146666667
POA3025,1103,2212,2.00543971,803,3445,2.290161893,414,1449,2.5,1217,4894,4.02136401,221,643,1.909502262,317,739,1.331230284,538,1382,2.568773234,79,166,2.101265823
POA3026,7,17,2.428571429,0,0,#DIV/0!,0,0,#DIV/0!,0,0,#DIV/0!,0,3,#DIV/0!,0,0,#DIV/0!,0,3,#DIV/0!,0,0,#DIV/0!
POA3027,300,604,2.013333333,387,1460,1.772609819,67,262,2.910447761,454,1722,3.792951542,58,176,2.034482759,49,103,1.102040816,107,279,2.607476636,18,38,2.111111111
POA3028,2314,4694,2.02852204,2284,9071,1.971541156,1344,4732,2.520833333,3628,13803,3.804575524,638,1862,1.918495298,778,1856,1.385604113,1416,3718,2.625706215,152,349,2.296052632
POA3029,5337,10818,2.02698145,6879,28299,2.113824684,2807,9977,2.554328465,9686,38276,3.951682841,1738,5319,2.060414269,1277,3041,1.381362569,3015,8360,2.772802653,277,604,2.180505415
POA3030,6398,12847,2.007971241,8488,33859,1.989043355,2748,9676,2.521106259,11236,43535,3.874599502,1803,5329,1.955629506,1380,3223,1.335507246,3183,8552,2.686773484,317,703,2.217665615
POA3031,1775,3496,1.969577465,1133,4334,1.825242718,273,928,2.399267399,1406,5262,3.742532006,375,1132,2.018666667,342,778,1.274853801,717,1910,2.663877266,180,372,2.066666667
POA3032,2452,4907,2.001223491,1962,7609,1.878185525,874,3043,2.481693364,2836,10652,3.755994358,408,1145,1.806372549,519,1163,1.240847784,927,2308,2.489751888,236,492,2.084745763
POA3033,1435,2867,1.997909408,1040,4163,2.002884615,757,2612,2.450462351,1797,6775,3.77017251,205,569,1.775609756,346,803,1.320809249,551,1372,2.490018149,63,126,2
POA3034,1223,2464,2.014717907,761,3050,2.007884363,697,2437,2.496413199,1458,5487,3.763374486,164,490,1.987804878,299,689,1.304347826,463,1179,2.546436285,63,138,2.19047619
POA3036,576,1150,1.996527778,462,1967,2.257575758,396,1380,2.484848485,858,3347,3.900932401,81,245,2.024691358,109,257,1.357798165,190,502,2.642105263,20,42,2.1
POA3037,2848,5764,2.023876404,5569,22920,2.115640151,2146,7800,2.634669152,7715,30720,3.981853532,961,2908,2.026014568,806,1992,1.47146402,1767,4900,2.773061686,154,336,2.181818182
POA3038,2067,4157,2.011127238,2376,10037,2.224326599,2247,8205,2.651535381,4623,18242,3.945922561,441,1388,2.14739229,621,1560,1.512077295,1062,2948,2.775894539,86,177,2.058139535
POA3039,1272,2517,1.978773585,1122,4430,1.948306595,548,1889,2.447080292,1670,6319,3.783832335,139,368,1.647482014,231,524,1.268398268,370,892,2.410810811,90,200,2.222222222
POA3040,2011,3988,1.983092989,2000,8189,2.0945,1125,4098,2.642666667,3125,12287,3.93184,261,673,1.578544061,489,1129,1.308793456,750,1802,2.402666667,164,350,2.134146341
POA3041,901,1794,1.991120977,1005,4210,2.189054726,637,2259,2.546310832,1642,6469,3.939707674,149,388,1.604026846,250,584,1.336,399,972,2.436090226,49,99,2.020408163
POA3042,1556,3086,1.983290488,1087,4359,2.010119595,673,2304,2.423476969,1760,6663,3.785795455,267,750,1.808988764,474,1092,1.303797468,741,1842,2.48582996,100,211,2.11
POA3043,1797,3617,2.01279911,1243,5048,2.061142397,894,3117,2.486577181,2137,8165,3.82077679,375,1053,1.808,518,1219,1.353281853,893,2272,2.544232923,97,215,2.216494845
POA3044,2212,4437,2.005877034,2174,8677,1.99126035,925,3308,2.576216216,3099,11985,3.867376573,381,1077,1.826771654,574,1260,1.195121951,955,2337,2.447120419,164,345,2.103658537
POA3045,4,6,1.5,6,33,3.5,3,9,2,9,42,4.666666667,0,0,#DIV/0!,0,0,#DIV/0!,0,0,#DIV/0!,0,0,#DIV/0!
POA3046,2876,5799,2.016342142,2313,9580,2.141807177,1150,4050,2.52173913,3463,13630,3.935893734,574,1784,2.108013937,842,1920,1.280285036,1416,3704,2.615819209,198,414,2.090909091
POA3047,1103,2242,2.032638259,1465,6717,2.584982935,678,2453,2.6179941,2143,9170,4.279048063,520,1745,2.355769231,636,1569,1.466981132,1156,3314,2.866782007,111,241,2.171171171
POA3048,877,1770,2.018244014,1734,7831,2.516147636,837,3043,2.635603345,2571,10874,4.229482692,560,1898,2.389285714,555,1401,1.524324324,1115,3299,2.958744395,80,175,2.1875
POA3049,722,1460,2.022160665,699,2908,2.160228898,545,1974,2.622018349,1244,4882,3.924437299,165,488,1.957575758,268,646,1.410447761,433,1134,2.618937644,41,91,2.219512195
POA3051,1090,2134,1.957798165,485,1944,2.008247423,165,555,2.363636364,650,2499,3.844615385,173,505,1.919075145,220,489,1.222727273,393,994,2.529262087,157,329,2.095541401
POA3052,422,824,1.952606635,166,620,1.734939759,89,303,2.404494382,255,923,3.619607843,40,105,1.625,51,101,0.980392157,91,206,2.263736264,50,114,2.28
POA3053,1002,1968,1.964071856,308,1268,2.116883117,88,295,2.352272727,396,1563,3.946969697,145,476,2.282758621,171,388,1.269005848,316,864,2.734177215,321,678,2.112149533
POA3054,942,1835,1.947983015,454,1701,1.746696035,161,521,2.236024845,615,2222,3.61300813,92,222,1.413043478,143,308,1.153846154,235,530,2.255319149,78,170,2.179487179
POA3055,1328,2642,1.989457831,859,3279,1.817229336,401,1385,2.453865337,1260,4664,3.701587302,162,441,1.722222222,272,616,1.264705882,434,1057,2.435483871,127,270,2.125984252
POA3056,2502,4928,1.969624301,1359,5053,1.718175129,533,1794,2.365853659,1892,6847,3.618921776,193,515,1.668393782,425,939,1.209411765,618,1454,2.352750809,197,414,2.101522843
POA3057,955,1891,1.980104712,525,1955,1.723809524,203,687,2.384236453,728,2642,3.629120879,77,197,1.558441558,175,374,1.137142857,252,571,2.265873016,73,149,2.04109589
POA3058,2862,5721,1.998951782,2517,9924,1.942789035,1192,4224,2.543624161,3709,14148,3.814505257,457,1254,1.743982495,779,1805,1.317073171,1236,3059,2.474919094,221,472,2.135746606
POA3059,710,1423,2.004225352,1260,5408,2.292063492,971,3544,2.64984552,2231,8952,4.012550426,135,434,2.214814815,175,431,1.462857143,310,865,2.790322581,26,57,2.192307692
POA3060,1062,2148,2.02259887,1015,4501,2.434482759,502,1815,2.615537849,1517,6316,4.163480554,217,691,2.184331797,378,869,1.298941799,595,1560,2.621848739,90,192,2.133333333
POA3061,389,783,2.01285347,426,2067,2.852112676,264,962,2.643939394,690,3029,4.389855072,104,386,2.711538462,129,319,1.472868217,233,705,3.025751073,20,47,2.35
POA3062,0,0,#DIV/0!,0,0,#DIV/0!,0,0,#DIV/0!,0,0,#DIV/0!,0,0,#DIV/0!,0,0,#DIV/0!,0,0,#DIV/0!,0,0,#DIV/0!
POA3063,57,120,2.105263158,53,241,2.547169811,46,152,2.304347826,99,393,3.96969697,9,27,2,9,26,1.888888889,18,53,2.944444444,4,12,3
POA3064,3087,6267,2.030126336,6149,26191,2.259391771,2204,8246,2.74137931,8353,34437,4.122710403,1377,4381,2.181554103,976,2439,1.49897541,2353,6820,2.898427539,171,380,2.222222222
POA3065,1037,2035,1.962391514,382,1461,1.82460733,108,339,2.138888889,490,1800,3.673469388,203,619,2.049261084,165,363,1.2,368,982,2.668478261,85,169,1.988235294
POA3066,694,1356,1.95389049,252,942,1.738095238,61,199,2.262295082,313,1141,3.645367412,202,571,1.826732673,122,283,1.319672131,324,854,2.635802469,61,125,2.049180328
POA3067,506,992,1.960474308,253,934,1.691699605,106,372,2.509433962,359,1306,3.637883008,35,93,1.657142857,95,214,1.252631579,130,307,2.361538462,45,97,2.155555556
POA3068,1887,3714,1.968203498,1129,4274,1.785651019,427,1424,2.334894614,1556,5698,3.661953728,201,524,1.606965174,301,664,1.205980066,502,1188,2.366533865,117,238,2.034188034
POA3070,2172,4278,1.96961326,1863,7200,1.8647343,708,2431,2.433615819,2571,9631,3.746013224,303,788,1.600660066,466,1021,1.190987124,769,1809,2.352405722,166,335,2.018072289
POA3071,1756,3478,1.980637813,1340,5115,1.817164179,498,1693,2.399598394,1838,6808,3.704026115,245,632,1.579591837,364,799,1.195054945,609,1431,2.349753695,125,259,2.072
POA3072,2614,5248,2.007651109,2278,8879,1.897717296,1055,3682,2.490047393,3333,12561,3.768676868,523,1488,1.845124283,775,1793,1.313548387,1298,3281,2.527734977,240,513,2.1375
POA3073,4499,9063,2.014447655,3338,13392,2.011983223,1892,6654,2.516913319,5230,20046,3.832887189,979,2834,1.894790603,1375,3134,1.279272727,2354,5968,2.535259133,380,820,2.157894737
POA3074,1974,3994,2.023302938,1432,6036,2.215083799,1256,4390,2.49522293,2688,10426,3.878720238,445,1396,2.137078652,577,1367,1.36915078,1022,2763,2.703522505,111,250,2.252252252
POA3075,1920,3916,2.039583333,1444,6272,2.343490305,1083,3724,2.438596491,2527,9996,3.95567867,462,1463,2.166666667,667,1606,1.407796102,1129,3069,2.71833481,100,216,2.16
POA3076,2022,4080,2.017804154,2581,10498,2.06741573,1288,4586,2.560559006,3869,15084,3.89868183,618,1876,2.035598706,624,1524,1.442307692,1242,3400,2.737520129,113,245,2.168141593
POA3078,995,1973,1.982914573,913,3582,1.923329682,354,1230,2.474576271,1267,4812,3.797947908,107,278,1.598130841,188,418,1.223404255,295,696,2.359322034,67,141,2.104477612
POA3079,1275,2519,1.975686275,1316,5274,2.007598784,734,2569,2.5,2050,7843,3.825853659,179,486,1.715083799,302,690,1.284768212,481,1176,2.444906445,86,179,2.081395349
POA3081,1017,2050,2.015732547,866,3539,2.086605081,369,1269,2.43902439,1235,4808,3.893117409,425,1278,2.007058824,481,1110,1.307692308,906,2388,2.635761589,113,251,2.221238938
POA3082,2185,4421,2.023340961,2720,11266,2.141911765,2059,7406,2.596891695,4779,18672,3.907093534,581,1767,2.04130809,752,1850,1.460106383,1333,3617,2.713428357,129,277,2.147286822
POA3083,2631,5315,2.020144432,2138,8657,2.049111319,1360,4731,2.478676471,3498,13388,3.827329903,418,1223,1.925837321,624,1432,1.294871795,1042,2655,2.547984645,171,367,2.14619883
POA3084,2491,4950,1.987153754,2126,8469,1.983537159,1189,4074,2.426408747,3315,12543,3.783710407,308,795,1.581168831,544,1228,1.257352941,852,2023,2.374413146,89,186,2.08988764
POA3085,1271,2514,1.977970102,1268,4961,1.912460568,563,1950,2.463587922,1831,6911,3.774440197,187,500,1.673796791,294,685,1.329931973,481,1185,2.463617464,51,111,2.176470588
POA3086,0,0,#DIV/0!,0,0,#DIV/0!,0,0,#DIV/0!,0,0,#DIV/0!,0,0,#DIV/0!,0,0,#DIV/0!,0,0,#DIV/0!,0,0,#DIV/0!
POA3087,928,1858,2.002155172,726,2913,2.012396694,425,1469,2.456470588,1151,4382,3.80712424,174,512,1.942528736,257,585,1.276264591,431,1097,2.545243619,37,81,2.189189189
POA3088,2499,4986,1.995198079,2293,9237,2.028347143,1472,5145,2.495244565,3765,14382,3.819920319,453,1250,1.759381898,658,1529,1.323708207,1111,2779,2.501350135,95,199,2.094736842
POA3089,852,1684,1.976525822,1146,4794,2.183246073,722,2606,2.609418283,1868,7400,3.961456103,183,528,1.885245902,245,585,1.387755102,428,1113,2.60046729,23,50,2.173913043
POA3090,140,276,1.971428571,232,1023,2.409482759,152,541,2.559210526,384,1564,4.072916667,20,55,1.75,13,46,2.538461538,33,101,3.060606061,3,11,3.666666667
POA3091,125,242,1.936,135,602,2.459259259,112,404,2.607142857,247,1006,4.072874494,17,53,2.117647059,22,51,1.318181818,39,104,2.666666667,3,11,3.666666667
POA3093,384,750,1.953125,271,1124,2.147601476,191,685,2.586387435,462,1809,3.915584416,56,142,1.535714286,69,154,1.231884058,125,296,2.368,21,43,2.047619048
POA3094,907,1798,1.982359427,758,2993,1.948548813,414,1450,2.502415459,1172,4443,3.790955631,152,423,1.782894737,241,543,1.253112033,393,966,2.458015267,31,65,2.096774194
POA3095,2243,4439,1.979045921,2669,11082,2.152116898,1847,6507,2.523010287,4516,17589,3.894818423,389,1059,1.722365039,524,1198,1.286259542,913,2257,2.472070099,61,135,2.213114754
POA3096,134,257,1.917910448,206,866,2.203883495,117,414,2.538461538,323,1280,3.962848297,21,65,2.095238095,27,71,1.62962963,48,136,2.833333333,3,9,3
POA3097,128,255,1.9921875,120,512,2.266666667,77,260,2.376623377,197,772,3.918781726,18,42,1.333333333,8,15,0.875,26,57,2.192307692,3,6,2
POA3099,442,877,1.984162896,443,1846,2.167042889,312,1104,2.538461538,755,2950,3.907284768,77,228,1.961038961,81,181,1.234567901,158,409,2.588607595,8,22,2.75
POA3101,2116,4194,1.982041588,1857,7547,2.064081852,1080,3769,2.489814815,2937,11316,3.852911134,260,683,1.626923077,469,1072,1.285714286,729,1755,2.407407407,140,297,2.121428571
POA3102,495,983,1.985858586,586,2350,2.010238908,293,1014,2.460750853,879,3364,3.827076223,58,156,1.689655172,150,343,1.286666667,208,499,2.399038462,22,42,1.909090909
POA3103,1295,2553,1.971428571,1242,5053,2.068438003,891,3132,2.515151515,2133,8185,3.837318331,210,559,1.661904762,348,799,1.295977011,558,1358,2.433691756,85,185,2.176470588
POA3104,1625,3207,1.973538462,1891,7762,2.104706504,1251,4430,2.541167066,3142,12192,3.880330999,229,678,1.96069869,468,1109,1.36965812,697,1787,2.56384505,78,174,2.230769231
POA3105,1223,2446,2,888,3514,1.957207207,648,2241,2.458333333,1536,5755,3.746744792,124,352,1.838709677,257,582,1.26459144,381,934,2.45144357,60,125,2.083333333
POA3106,1570,3105,1.977707006,1301,5370,2.127594158,1289,4573,2.547711404,2590,9943,3.838996139,189,552,1.920634921,303,717,1.366336634,492,1269,2.579268293,62,143,2.306451613
POA3107,1403,2816,2.007127584,1058,4222,1.990548204,775,2641,2.407741935,1833,6863,3.744135297,148,422,1.851351351,309,728,1.355987055,457,1150,2.516411379,64,129,2.015625
POA3108,2134,4289,2.009840675,1334,5229,1.919790105,1051,3554,2.381541389,2385,8783,3.682599581,237,662,1.793248945,500,1149,1.298,737,1811,2.457259159,118,251,2.127118644
POA3109,2652,5320,2.006033183,2280,9048,1.968421053,1684,5890,2.497624703,3964,14938,3.768415742,368,1047,1.845108696,677,1573,1.323485968,1045,2620,2.507177033,123,260,2.113821138
POA3111,1153,2287,1.983521249,1020,4158,2.076470588,712,2499,2.509831461,1732,6657,3.843533487,138,412,1.985507246,233,532,1.283261803,371,944,2.544474394,34,71,2.088235294
POA3113,702,1400,1.994301994,867,3624,2.179930796,540,1908,2.533333333,1407,5532,3.931769723,101,279,1.762376238,140,313,1.235714286,241,592,2.456431535,13,30,2.307692308
POA3114,308,606,1.967532468,358,1567,2.377094972,262,944,2.603053435,620,2511,4.05,29,87,2,46,114,1.47826087,75,201,2.68,3,14,4.666666667
POA3115,328,643,1.960365854,385,1643,2.267532468,279,995,2.566308244,664,2638,3.972891566,48,120,1.5,39,94,1.41025641,87,214,2.459770115,3,6,2
POA3116,1001,1999,1.997002997,747,3091,2.137884873,476,1661,2.489495798,1223,4752,3.885527392,159,461,1.899371069,208,503,1.418269231,367,964,2.626702997,34,65,1.911764706
POA3121,3176,6259,1.970717884,1263,4669,1.696753761,550,1822,2.312727273,1813,6491,3.580253723,385,1059,1.750649351,526,1195,1.271863118,911,2254,2.474204171,257,534,2.077821012
POA3122,2225,4390,1.973033708,1332,5204,1.906906907,565,1972,2.490265487,1897,7176,3.782814971,158,392,1.481012658,280,622,1.221428571,438,1014,2.315068493,207,440,2.125603865
POA3123,1325,2601,1.963018868,973,3879,1.98663926,436,1529,2.506880734,1409,5408,3.838183109,121,317,1.619834711,221,501,1.266968326,342,818,2.391812865,108,222,2.055555556
POA3124,1754,3477,1.982326112,1781,7291,2.093767546,1060,3694,2.48490566,2841,10985,3.866596269,172,463,1.691860465,392,913,1.329081633,564,1376,2.439716312,94,207,2.20212766
POA3125,1064,2134,2.005639098,881,3526,2.002270148,477,1602,2.358490566,1358,5128,3.776141384,184,486,1.641304348,286,633,1.213286713,470,1119,2.380851064,94,210,2.234042553
POA3126,717,1422,1.983263598,657,2741,2.171993912,460,1624,2.530434783,1117,4365,3.90778872,57,166,1.912280702,141,319,1.262411348,198,485,2.449494949,32,63,1.96875
POA3127,1517,2985,1.967699407,1661,6769,2.07525587,990,3470,2.505050505,2651,10239,3.862316107,178,478,1.685393258,339,762,1.247787611,517,1240,2.398452611,82,182,2.219512195
POA3128,1492,3005,2.014075067,1274,4977,1.906593407,604,2096,2.470198675,1878,7073,3.766240682,226,611,1.703539823,416,937,1.252403846,642,1548,2.411214953,161,345,2.142857143
POA3129,1449,2889,1.99378882,1442,5670,1.932038835,655,2243,2.424427481,2097,7913,3.773485932,235,659,1.804255319,467,1058,1.265524625,702,1717,2.445868946,106,223,2.103773585
POA3130,2797,5571,1.991776904,2774,11165,2.024873828,1311,4521,2.448512586,4085,15686,3.839902081,404,1121,1.774752475,701,1593,1.272467903,1105,2714,2.456108597,141,295,2.092198582
POA3131,2032,4044,1.99015748,1852,7368,1.978401728,774,2656,2.431524548,2626,10024,3.81721249,312,849,1.721153846,559,1264,1.26118068,871,2113,2.425947187,125,270,2.16
POA3132,1543,3090,2.002592353,1368,5394,1.942982456,535,1848,2.454205607,1903,7242,3.805570152,209,578,1.765550239,348,781,1.244252874,557,1359,2.439856373,79,173,2.189873418
POA3133,2167,4320,1.993539455,1831,7483,2.086837794,1315,4541,2.453231939,3146,12024,3.821996186,264,759,1.875,457,1050,1.297592998,721,1809,2.509015257,74,150,2.027027027
POA3134,2844,5637,1.982067511,2720,11062,2.066911765,1489,5247,2.523841504,4209,16309,3.874792112,593,1676,1.826306914,704,1605,1.279829545,1297,3281,2.529683886,120,256,2.133333333
POA3135,1945,3864,1.986632391,1624,6506,2.006157635,716,2469,2.448324022,2340,8975,3.835470085,326,921,1.825153374,470,1076,1.289361702,796,1997,2.50879397,85,174,2.047058824
POA3136,3955,7873,1.990644753,3310,13526,2.086404834,1837,6394,2.480675014,5147,19920,3.87021566,847,2370,1.79811098,1084,2433,1.244464945,1931,4803,2.487312273,170,357,2.1
POA3137,1218,2425,1.990968801,1085,4474,2.123502304,585,2056,2.514529915,1670,6530,3.910179641,296,813,1.746621622,325,754,1.32,621,1567,2.523349436,51,108,2.117647059
POA3138,1847,3706,2.006497022,1849,7640,2.131963223,1049,3649,2.478551001,2898,11289,3.895445135,442,1316,1.977375566,490,1128,1.302040816,932,2444,2.622317597,85,177,2.082352941
POA3139,1288,2551,1.980590062,1247,5247,2.207698476,656,2265,2.452743902,1903,7512,3.947451393,270,806,1.985185185,226,501,1.216814159,496,1307,2.635080645,32,63,1.96875
POA3140,1465,2891,1.97337884,1374,5690,2.141193595,740,2576,2.481081081,2114,8266,3.91012299,323,915,1.832817337,332,760,1.289156627,655,1675,2.557251908,57,119,2.087719298
POA3141,2568,4999,1.94665109,688,2512,1.651162791,309,992,2.210355987,997,3504,3.514543631,158,433,1.740506329,299,651,1.177257525,457,1084,2.371991247,205,423,2.063414634
POA3142,1685,3291,1.953115727,663,2646,1.990950226,499,1647,2.300601202,1162,4293,3.694492255,100,267,1.67,216,481,1.226851852,316,748,2.367088608,97,196,2.020618557
POA3143,1045,2060,1.971291866,555,2152,1.877477477,207,693,2.347826087,762,2845,3.733595801,88,228,1.590909091,137,311,1.270072993,225,539,2.395555556,78,170,2.179487179
POA3144,973,1922,1.975334018,865,3546,2.099421965,474,1595,2.364978903,1339,5141,3.839432412,99,261,1.636363636,168,395,1.351190476,267,656,2.456928839,56,116,2.071428571
POA3145,1766,3492,1.977349943,1870,7434,1.97540107,912,3183,2.490131579,2782,10617,3.816319195,195,515,1.641025641,377,834,1.212201592,572,1349,2.358391608,153,320,2.091503268
POA3146,2147,4250,1.979506288,2313,9297,2.019455253,1173,4030,2.435635124,3486,13327,3.823006311,230,616,1.67826087,471,1083,1.299363057,701,1699,2.423680456,144,300,2.083333333
POA3147,1066,2117,1.985928705,1281,5074,1.960967994,579,1989,2.435233161,1860,7063,3.797311828,227,620,1.731277533,316,708,1.240506329,543,1328,2.445672192,86,174,2.023255814
POA3148,736,1482,2.013586957,566,2149,1.796819788,288,981,2.40625,854,3130,3.665105386,125,359,1.872,214,485,1.26635514,339,844,2.489675516,65,144,2.215384615
POA3149,3350,6690,1.997014925,2659,10643,2.002632569,1694,5840,2.447461629,4353,16483,3.786583965,435,1216,1.795402299,772,1763,1.283678756,1207,2979,2.468102734,168,358,2.130952381
POA3150,5760,11546,2.004513889,4698,18784,1.998297148,3704,12862,2.472462203,8402,31646,3.76648417,713,2030,1.847124825,1358,3146,1.316642121,2071,5176,2.499275712,289,625,2.162629758
POA3151,1078,2166,2.009276438,744,2933,1.942204301,534,1833,2.43258427,1278,4766,3.729264476,108,318,1.944444444,278,635,1.284172662,386,953,2.468911917,48,108,2.25
POA3152,2847,5704,2.003512469,2366,9725,2.110312764,2309,8132,2.52187094,4675,17857,3.819679144,447,1334,1.984340045,676,1598,1.363905325,1123,2932,2.610863758,123,260,2.113821138
POA3153,1928,3844,1.993775934,1546,6085,1.935963777,817,2804,2.432068543,2363,8889,3.761743546,473,1369,1.894291755,541,1205,1.227356747,1014,2574,2.538461538,100,198,1.98
POA3154,432,872,2.018518519,386,1585,2.106217617,199,684,2.43718593,585,2269,3.878632479,72,218,2.027777778,95,212,1.231578947,167,430,2.574850299,14,27,1.928571429
POA3155,2176,4353,2.000459559,1500,5989,1.992666667,842,2889,2.43111639,2342,8878,3.790777114,529,1471,1.780718336,627,1397,1.228070175,1156,2868,2.480968858,103,211,2.048543689
POA3156,3093,6181,1.998383446,3203,13108,2.092413362,1881,6577,2.496544391,5084,19685,3.87195122,689,1955,1.837445573,833,1923,1.308523409,1522,3878,2.547963206,132,271,2.053030303
POA3158,608,1205,1.981907895,617,2556,2.142625608,382,1337,2.5,999,3893,3.896896897,136,369,1.713235294,165,377,1.284848485,301,746,2.478405316,26,59,2.269230769
POA3159,216,422,1.953703704,256,1053,2.11328125,144,497,2.451388889,400,1550,3.875,50,144,1.88,36,76,1.111111111,86,220,2.558139535,3,9,3
POA3160,774,1522,1.966408269,819,3357,2.098901099,463,1599,2.453563715,1282,4956,3.865834633,195,543,1.784615385,211,489,1.317535545,406,1032,2.541871921,22,47,2.136363636
POA3161,1466,2928,1.997271487,1071,4452,2.156862745,593,2090,2.524451939,1664,6542,3.931490385,146,367,1.51369863,223,495,1.219730942,369,862,2.33604336,93,193,2.075268817
POA3162,1598,3186,1.993742178,1410,5597,1.969503546,730,2539,2.478082192,2140,8136,3.801869159,188,497,1.643617021,315,709,1.250793651,503,1206,2.397614314,57,115,2.01754386
POA3163,3052,6114,2.00327654,2347,8915,1.798466127,932,3188,2.420600858,3279,12103,3.691064349,303,787,1.597359736,510,1109,1.174509804,813,1896,2.332103321,275,580,2.109090909
POA3165,2335,4681,2.004710921,2467,9801,1.972841508,1220,4194,2.437704918,3687,13995,3.795768918,448,1222,1.727678571,645,1478,1.291472868,1093,2700,2.470265325,113,233,2.061946903
POA3166,1997,4024,2.015022534,1961,7673,1.912799592,833,2818,2.382953181,2794,10491,3.754831782,285,785,1.754385965,503,1149,1.284294235,788,1934,2.454314721,182,398,2.186813187
POA3167,821,1656,2.017052375,732,2906,1.969945355,552,1936,2.507246377,1284,4842,3.771028037,126,354,1.80952381,215,498,1.31627907,341,852,2.498533724,45,101,2.244444444
POA3168,1462,2988,2.04377565,904,3443,1.808628319,405,1368,2.377777778,1309,4811,3.675324675,169,477,1.822485207,298,680,1.281879195,467,1157,2.47751606,217,457,2.105990783
POA3169,1720,3534,2.054651163,1418,5671,1.999294781,1054,3717,2.526565465,2472,9388,3.797734628,293,882,2.010238908,548,1295,1.363138686,841,2177,2.588585018,164,362,2.207317073
POA3170,1815,3666,2.019834711,1504,5917,1.934175532,1026,3542,2.452241715,2530,9459,3.738735178,240,669,1.7875,434,1013,1.334101382,674,1682,2.495548961,90,195,2.166666667
POA3171,1673,3476,2.077704722,1467,6134,2.181322427,837,3020,2.608124253,2304,9154,3.973090278,446,1383,2.100896861,572,1375,1.403846154,1018,2758,2.709233792,158,365,2.310126582
POA3172,1883,3815,2.026022305,1827,7613,2.166940339,1236,4408,2.566343042,3063,12021,3.924583741,503,1555,2.091451292,589,1408,1.39049236,1092,2963,2.713369963,106,244,2.301886792
POA3173,1531,3122,2.039190072,1820,7567,2.157692308,1225,4378,2.573877551,3045,11945,3.922824302,359,1141,2.178272981,439,1111,1.530751708,798,2252,2.822055138,98,221,2.255102041
POA3174,3102,6350,2.047066409,2673,11007,2.117845118,1395,4878,2.496774194,4068,15885,3.904867257,925,2852,2.083243243,1117,2577,1.307072516,2042,5429,2.658667973,276,614,2.224637681
POA3175,3896,7880,2.022587269,3944,16374,2.151622718,1940,6800,2.505154639,5884,23174,3.938477226,1026,3143,2.063352827,1226,2862,1.334420881,2252,6005,2.66651865,279,604,2.164874552
POA3177,755,1542,2.042384106,727,3085,2.2434663,366,1297,2.543715847,1093,4382,4.009149131,345,1143,2.313043478,342,781,1.283625731,687,1924,2.800582242,61,131,2.147540984
POA3178,2532,5092,2.011058452,3718,15198,2.087681549,2170,7820,2.603686636,5888,23018,3.909307065,525,1543,1.939047619,640,1551,1.4234375,1165,3094,2.655793991,90,195,2.166666667
POA3179,491,994,2.024439919,556,2234,2.017985612,344,1230,2.575581395,900,3464,3.848888889,100,287,1.87,160,403,1.51875,260,690,2.653846154,26,53,2.038461538
POA3180,811,1621,1.998766954,610,2460,2.032786885,323,1099,2.40247678,933,3559,3.814576635,147,442,2.006802721,186,410,1.204301075,333,852,2.558558559,23,47,2.043478261
POA3181,2185,4253,1.946453089,792,2877,1.632575758,277,898,2.241877256,1069,3775,3.531337699,163,409,1.509202454,299,639,1.137123746,462,1048,2.268398268,160,326,2.0375
POA3182,2628,5129,1.951674277,735,2615,1.557823129,209,687,2.28708134,944,3302,3.497881356,199,472,1.371859296,228,491,1.153508772,427,963,2.255269321,147,297,2.020408163
POA3183,1945,3834,1.971208226,1083,4664,2.306555863,298,1011,2.39261745,1381,5675,4.109341057,199,488,1.452261307,247,527,1.133603239,446,1015,2.275784753,136,286,2.102941176
POA3184,1731,3373,1.948584633,899,3289,1.658509455,223,739,2.313901345,1122,4028,3.590017825,193,431,1.233160622,215,434,1.018604651,408,865,2.120098039,100,209,2.09
POA3185,1156,2293,1.983564014,989,4030,2.074823054,341,1151,2.375366569,1330,5181,3.895488722,147,369,1.510204082,220,465,1.113636364,367,834,2.272479564,78,153,1.961538462
POA3186,2173,4241,1.951679705,1773,7120,2.015792442,988,3363,2.403846154,2761,10483,3.796812749,242,657,1.714876033,408,923,1.262254902,650,1580,2.430769231,91,195,2.142857143
POA3187,1346,2642,1.962852897,1510,6027,1.991390728,747,2619,2.506024096,2257,8646,3.830748782,192,546,1.84375,330,731,1.215151515,522,1277,2.446360153,31,65,2.096774194
POA3188,1365,2698,1.976556777,1646,6632,2.029161604,678,2337,2.446902655,2324,8969,3.85929432,303,825,1.722772277,405,908,1.241975309,708,1733,2.447740113,69,139,2.014492754
POA3189,522,1046,2.003831418,446,1725,1.867713004,236,807,2.419491525,682,2532,3.712609971,80,208,1.6,137,309,1.255474453,217,517,2.382488479,39,80,2.051282051
POA3190,949,1873,1.973656481,956,3697,1.867154812,336,1148,2.416666667,1292,4845,3.75,175,464,1.651428571,318,703,1.210691824,493,1167,2.367139959,45,99,2.2
POA3191,826,1616,1.956416465,886,3575,2.034988713,385,1324,2.438961039,1271,4899,3.854445319,119,310,1.605042017,170,363,1.135294118,289,673,2.328719723,29,64,2.206896552
POA3192,2039,4051,1.986758215,1698,6653,1.918138987,839,2886,2.439809297,2537,9539,3.7599527,313,868,1.773162939,541,1213,1.242144177,854,2081,2.43676815,91,192,2.10989011
POA3193,2010,3952,1.966169154,1717,6979,2.064647641,957,3318,2.467084639,2674,10297,3.85078534,175,474,1.708571429,386,869,1.251295337,561,1343,2.393939394,48,98,2.041666667
POA3194,1236,2448,1.980582524,862,3399,1.943155452,491,1711,2.484725051,1353,5110,3.776792313,153,393,1.568627451,309,667,1.158576052,462,1060,2.294372294,54,114,2.111111111
POA3195,2964,5890,1.987179487,3411,13698,2.015831135,1488,5208,2.5,4899,18906,3.85915493,489,1325,1.709611452,665,1520,1.285714286,1154,2845,2.465337955,120,250,2.083333333
POA3196,2418,4820,1.993382961,1866,7256,1.888531618,803,2721,2.388542964,2669,9977,3.738104159,484,1313,1.712809917,611,1382,1.261865794,1095,2695,2.461187215,102,212,2.078431373
POA3197,1231,2441,1.982940699,881,3475,1.944381385,463,1576,2.403887689,1344,5051,3.758184524,228,640,1.807017544,236,544,1.305084746,464,1184,2.551724138,42,99,2.357142857
POA3198,1655,3318,2.004833837,1050,4139,1.941904762,521,1794,2.443378119,1571,5933,3.77657543,419,1187,1.832935561,502,1120,1.231075697,921,2307,2.504885993,87,177,2.034482759
POA3199,5181,10285,1.985138004,3619,14634,2.043658469,2017,6729,2.336142786,5636,21363,3.790454223,1501,4256,1.835443038,1493,3324,1.226389819,2994,7580,2.531730127,243,512,2.106995885
POA3200,423,862,2.037825059,273,1151,2.216117216,171,573,2.350877193,444,1724,3.882882883,303,925,2.052805281,233,542,1.326180258,536,1467,2.736940299,40,78,1.95
POA3201,1467,2934,2,1665,6742,2.049249249,648,2228,2.438271605,2313,8970,3.878080415,589,1701,1.887945671,501,1132,1.259481038,1090,2833,2.599082569,77,163,2.116883117
POA3202,191,383,2.005235602,340,1319,1.879411765,96,320,2.333333333,436,1639,3.759174312,34,101,1.970588235,53,122,1.301886792,87,223,2.563218391,10,18,1.8
POA3204,2255,4478,1.985809313,2791,11049,1.95879613,1233,4317,2.501216545,4024,15366,3.818588469,412,1102,1.674757282,619,1377,1.224555735,1031,2479,2.404461688,147,311,2.115646259
POA3205,1187,2337,1.968828981,506,1821,1.598814229,138,469,2.398550725,644,2290,3.555900621,149,398,1.67114094,184,411,1.233695652,333,809,2.429429429,80,180,2.25
POA3206,1239,2404,1.940274415,791,2966,1.749683944,280,907,2.239285714,1071,3873,3.616246499,120,293,1.441666667,165,355,1.151515152,285,648,2.273684211,58,118,2.034482759
POA3207,2018,3923,1.944003964,878,3222,1.669703872,333,1061,2.186186186,1211,4283,3.536746491,208,543,1.610576923,268,575,1.145522388,476,1118,2.348739496,81,166,2.049382716
POA3211,141,270,1.914893617,116,502,2.327586207,87,287,2.298850575,203,789,3.886699507,29,88,2.034482759,19,47,1.473684211,48,135,2.8125,0,0,#DIV/0!
POA3212,1330,2629,1.976691729,1290,5284,2.096124031,579,1988,2.433506045,1869,7272,3.890850722,325,947,1.913846154,264,591,1.238636364,589,1538,2.611205433,29,67,2.310344828
POA3214,1947,3905,2.005649718,1347,5723,2.248700817,845,2813,2.328994083,2192,8536,3.894160584,1133,3498,2.087378641,798,1776,1.22556391,1931,5274,2.731227343,121,250,2.066115702
POA3215,2114,4200,1.986754967,1311,5342,2.074752098,822,2778,2.379562044,2133,8120,3.80684482,436,1266,1.903669725,541,1207,1.231053604,977,2473,2.531218014,91,182,2
POA3216,5603,11094,1.980010709,4137,16770,2.053662074,2066,6931,2.354791868,6203,23701,3.820893116,959,2769,1.88738269,975,2168,1.223589744,1934,4937,2.552740434,197,404,2.050761421
POA3217,95,189,1.989473684,113,457,2.044247788,45,149,2.311111111,158,606,3.835443038,19,60,2.157894737,18,40,1.222222222,37,100,2.702702703,8,4,0.5
POA3218,1225,2417,1.973061224,987,3868,1.918946302,315,1084,2.441269841,1302,4952,3.803379416,265,678,1.558490566,324,736,1.271604938,589,1414,2.400679117,65,137,2.107692308
POA3219,1987,3959,1.992450931,1324,5373,2.0581571,639,2125,2.325508607,1963,7498,3.81966378,652,1894,1.904907975,582,1281,1.201030928,1234,3175,2.572933549,110,227,2.063636364
POA3220,1531,3011,1.966688439,1174,4771,2.063884157,508,1660,2.267716535,1682,6431,3.823424495,199,516,1.592964824,290,636,1.193103448,489,1152,2.355828221,77,153,1.987012987
POA3221,754,1493,1.980106101,735,3105,2.224489796,392,1341,2.420918367,1127,4446,3.94498669,108,329,2.046296296,111,250,1.252252252,219,579,2.643835616,22,43,1.954545455
POA3222,1526,3024,1.981651376,947,3938,2.158394931,483,1645,2.405797101,1430,5583,3.904195804,207,625,2.019323671,265,600,1.264150943,472,1225,2.595338983,29,55,1.896551724
POA3223,1069,2117,1.980355472,329,1350,2.103343465,186,598,2.215053763,515,1948,3.782524272,151,443,1.933774834,104,228,1.192307692,255,671,2.631372549,16,30,1.875
POA3224,1204,2375,1.972591362,919,3725,2.053318825,388,1317,2.394329897,1307,5042,3.857689365,221,612,1.769230769,161,374,1.322981366,382,986,2.581151832,27,57,2.111111111
POA3225,570,1124,1.971929825,232,951,2.099137931,114,367,2.219298246,346,1318,3.809248555,51,156,2.058823529,59,116,0.966101695,110,272,2.472727273,10,18,1.8
POA3226,1395,2748,1.969892473,1072,4325,2.034514925,447,1492,2.337807606,1519,5817,3.829493088,284,782,1.753521127,227,530,1.334801762,511,1312,2.567514677,30,61,2.033333333
POA3227,456,893,1.958333333,391,1583,2.04859335,146,464,2.178082192,537,2047,3.811918063,81,224,1.765432099,60,129,1.15,141,353,2.503546099,13,24,1.846153846
POA3228,1456,2840,1.950549451,1516,6142,2.051451187,443,1447,2.266365688,1959,7589,3.873915263,263,747,1.840304183,215,453,1.106976744,478,1200,2.510460251,24,48,2
POA3230,294,571,1.942176871,161,639,1.968944099,80,252,2.15,241,891,3.697095436,40,112,1.8,48,104,1.166666667,88,216,2.454545455,5,6,1.2
POA3231,149,290,1.946308725,122,485,1.975409836,43,137,2.186046512,165,622,3.76969697,20,45,1.25,20,40,1,40,85,2.125,3,5,1.666666667
POA3232,113,216,1.911504425,60,222,1.7,25,79,2.16,85,301,3.541176471,11,31,1.818181818,15,34,1.266666667,26,65,2.5,3,3,1
POA3233,231,459,1.987012987,101,383,1.792079208,33,113,2.424242424,134,496,3.701492537,22,48,1.181818182,26,52,1,48,100,2.083333333,4,12,3
POA3235,47,90,1.914893617,31,116,1.741935484,14,49,2.5,45,165,3.666666667,11,25,1.272727273,9,17,0.888888889,20,42,2.1,0,0,#DIV/0!
POA3236,33,68,2.060606061,14,60,2.285714286,7,17,1.428571429,21,77,3.666666667,9,23,1.555555556,6,14,1.333333333,15,37,2.466666667,0,0,#DIV/0!
POA3237,56,110,1.964285714,32,128,2,15,45,2,47,173,3.680851064,6,20,2.333333333,13,24,0.846153846,19,44,2.315789474,0,0,#DIV/0!
POA3238,21,37,1.761904762,14,62,2.428571429,4,9,1.25,18,71,3.944444444,6,15,1.5,0,0,#DIV/0!,6,15,2.5,0,0,#DIV/0!
POA3239,47,93,1.978723404,22,81,1.681818182,17,60,2.529411765,39,141,3.615384615,10,32,2.2,15,25,0.666666667,25,57,2.28,0,5,#DIV/0!
POA3240,206,407,1.975728155,231,989,2.281385281,106,346,2.264150943,337,1335,3.961424332,18,53,1.944444444,22,57,1.590909091,40,110,2.75,3,5,1.666666667
POA3241,291,574,1.972508591,159,664,2.176100629,72,236,2.277777778,231,900,3.896103896,49,131,1.673469388,43,103,1.395348837,92,234,2.543478261,3,3,1
POA3242,92,175,1.902173913,66,270,2.090909091,19,65,2.421052632,85,335,3.941176471,14,33,1.357142857,10,30,2,24,63,2.625,4,4,1
POA3243,94,187,1.989361702,48,214,2.458333333,21,65,2.095238095,69,279,4.043478261,6,15,1.5,7,14,1,13,29,2.230769231,3,10,3.333333333
POA3249,346,683,1.973988439,264,1153,2.367424242,107,363,2.392523364,371,1516,4.086253369,52,154,1.961538462,39,87,1.230769231,91,241,2.648351648,13,28,2.153846154
POA3250,1251,2481,1.983213429,840,3549,2.225,383,1265,2.302872063,1223,4814,3.936222404,299,891,1.97993311,218,492,1.256880734,517,1383,2.675048356,48,96,2
POA3251,75,147,1.96,43,197,2.581395349,21,72,2.428571429,64,269,4.203125,12,31,1.583333333,20,42,1.1,32,73,2.28125,3,4,1.333333333
POA3254,34,65,1.911764706,44,192,2.363636364,14,46,2.285714286,58,238,4.103448276,3,11,2.666666667,3,4,0.333333333,6,15,2.5,0,3,#DIV/0!
POA3260,548,1085,1.979927007,316,1354,2.284810127,133,437,2.285714286,449,1791,3.988864143,101,291,1.881188119,85,174,1.047058824,186,465,2.5,8,19,2.375
POA3264,247,487,1.971659919,183,780,2.262295082,62,200,2.225806452,245,980,4,53,155,1.924528302,50,120,1.4,103,275,2.669902913,15,25,1.666666667
POA3265,269,528,1.962825279,276,1244,2.507246377,101,344,2.405940594,377,1588,4.212201592,36,113,2.138888889,45,98,1.177777778,81,211,2.604938272,8,19,2.375
POA3266,394,781,1.982233503,306,1344,2.392156863,113,359,2.17699115,419,1703,4.064439141,69,225,2.260869565,48,105,1.1875,117,330,2.820512821,5,14,2.8
POA3267,23,48,2.086956522,34,148,2.352941176,10,28,1.8,44,176,4,3,11,2.666666667,9,17,0.888888889,12,28,2.333333333,0,0,#DIV/0!
POA3268,259,515,1.988416988,226,1005,2.446902655,82,295,2.597560976,308,1300,4.220779221,46,130,1.826086957,48,103,1.145833333,94,233,2.478723404,8,11,1.375
POA3269,91,179,1.967032967,92,400,2.347826087,29,94,2.24137931,121,494,4.082644628,15,32,1.133333333,11,16,0.454545455,26,48,1.846153846,3,10,3.333333333
POA3270,20,35,1.75,3,13,2.333333333,0,0,#DIV/0!,3,13,4.333333333,8,19,1.375,6,8,0.333333333,14,27,1.928571429,0,0,#DIV/0!
POA3272,220,440,2,126,543,2.30952381,41,124,2.024390244,167,667,3.994011976,32,95,1.96875,29,73,1.517241379,61,168,2.754098361,6,11,1.833333333
POA3273,13,26,2,12,42,1.5,6,22,2.666666667,18,64,3.555555556,4,6,0.5,0,3,#DIV/0!,4,9,2.25,0,0,#DIV/0!
POA3274,34,67,1.970588235,28,123,2.392857143,15,43,1.866666667,43,166,3.860465116,9,24,1.666666667,0,6,#DIV/0!,9,30,3.333333333,4,6,1.5
POA3275,55,111,2.018181818,51,227,2.450980392,17,58,2.411764706,68,285,4.191176471,10,25,1.5,3,16,4.333333333,13,41,3.153846154,0,0,#DIV/0!
POA3276,59,113,1.915254237,53,222,2.188679245,23,68,1.956521739,76,290,3.815789474,8,27,2.375,6,13,1.166666667,14,40,2.857142857,0,0,#DIV/0!
POA3277,183,357,1.950819672,163,723,2.435582822,87,301,2.459770115,250,1024,4.096,35,104,1.971428571,25,50,1,60,154,2.566666667,5,6,1.2
POA3278,48,93,1.9375,42,191,2.547619048,20,62,2.1,62,253,4.080645161,9,28,2.111111111,11,26,1.363636364,20,54,2.7,3,3,1
POA3280,3035,6005,1.978583196,2202,9234,2.19346049,930,3087,2.319354839,3132,12321,3.933908046,781,2253,1.884763124,607,1330,1.191103789,1388,3583,2.581412104,132,270,2.045454545
POA3281,154,309,2.006493506,195,834,2.276923077,77,244,2.168831169,272,1078,3.963235294,21,58,1.761904762,21,51,1.428571429,42,109,2.595238095,4,11,2.75
POA3282,264,512,1.939393939,207,859,2.149758454,86,296,2.441860465,293,1155,3.941979522,46,124,1.695652174,36,72,1,82,196,2.390243902,16,31,1.9375
POA3283,96,194,2.020833333,102,427,2.18627451,36,126,2.5,138,553,4.007246377,4,19,3.75,20,34,0.7,24,53,2.208333333,3,8,2.666666667
POA3284,419,820,1.957040573,196,797,2.066326531,84,259,2.083333333,280,1056,3.771428571,68,203,1.985294118,48,104,1.166666667,116,307,2.646551724,8,19,2.375
POA3285,140,270,1.928571429,113,480,2.247787611,57,177,2.105263158,170,657,3.864705882,19,45,1.368421053,16,36,1.25,35,81,2.314285714,4,8,2
POA3286,84,164,1.952380952,53,227,2.283018868,17,58,2.411764706,70,285,4.071428571,13,35,1.692307692,6,14,1.333333333,19,49,2.578947368,3,0,0
POA3287,48,93,1.9375,48,216,2.5,12,44,2.666666667,60,260,4.333333333,6,17,1.833333333,3,8,1.666666667,9,25,2.777777778,0,0,#DIV/0!
POA3289,96,192,2,51,237,2.647058824,23,73,2.173913043,74,310,4.189189189,6,27,3.5,10,17,0.7,16,44,2.75,6,6,1
POA3292,46,104,2.260869565,11,52,2.727272727,15,47,2.133333333,26,99,3.807692308,6,10,0.666666667,3,3,0,9,13,1.444444444,3,0,0
POA3293,40,70,1.75,18,76,2.222222222,9,25,1.777777778,27,101,3.740740741,7,18,1.571428571,7,11,0.571428571,14,29,2.071428571,0,0,#DIV/0!
POA3294,109,210,1.926605505,53,221,2.169811321,19,60,2.157894737,72,281,3.902777778,8,23,1.875,10,23,1.3,18,46,2.555555556,0,0,#DIV/0!
POA3300,1211,2396,1.97853014,729,3046,2.178326475,293,947,2.232081911,1022,3993,3.90704501,210,588,1.8,163,348,1.134969325,373,936,2.509383378,27,61,2.259259259
POA3301,195,387,1.984615385,168,726,2.321428571,60,194,2.233333333,228,920,4.035087719,20,47,1.35,21,48,1.285714286,41,95,2.317073171,5,7,1.4
POA3302,79,149,1.886075949,49,229,2.673469388,21,57,1.714285714,70,286,4.085714286,6,17,1.833333333,0,8,#DIV/0!,6,25,4.166666667,0,4,#DIV/0!
POA3303,44,95,2.159090909,40,159,1.975,9,34,2.777777778,49,193,3.93877551,8,26,2.25,8,9,0.125,16,35,2.1875,3,4,1.333333333
POA3304,308,598,1.941558442,175,725,2.142857143,85,276,2.247058824,260,1001,3.85,54,160,1.962962963,47,99,1.106382979,101,259,2.564356436,8,19,2.375
POA3305,1405,2771,1.972241993,960,3874,2.035416667,415,1303,2.139759036,1375,5177,3.765090909,364,1026,1.818681319,227,490,1.158590308,591,1516,2.565143824,26,55,2.115384615
POA3309,25,55,2.2,20,85,2.25,9,29,2.222222222,29,114,3.931034483,0,0,#DIV/0!,0,6,#DIV/0!,0,6,#DIV/0!,0,0,#DIV/0!
POA3310,48,100,2.083333333,25,104,2.16,11,29,1.636363636,36,133,3.694444444,4,25,5.25,11,14,0.272727273,15,39,2.6,0,3,#DIV/0!
POA3311,254,491,1.933070866,90,402,2.466666667,47,147,2.127659574,137,549,4.00729927,26,93,2.576923077,36,64,0.777777778,62,157,2.532258065,7,14,2
POA3312,126,239,1.896825397,89,370,2.157303371,36,104,1.888888889,125,474,3.792,7,26,2.714285714,12,28,1.333333333,19,54,2.842105263,0,0,#DIV/0!
POA3314,93,179,1.924731183,81,349,2.308641975,27,79,1.925925926,108,428,3.962962963,7,24,2.428571429,16,26,0.625,23,50,2.173913043,0,3,#DIV/0!
POA3315,207,410,1.980676329,129,529,2.100775194,52,155,1.980769231,181,684,3.779005525,25,79,2.16,32,61,0.90625,57,140,2.456140351,4,9,2.25
POA3317,49,93,1.897959184,21,86,2.095238095,8,24,2,29,110,3.793103448,3,16,4.333333333,6,7,0.166666667,9,23,2.555555556,3,10,3.333333333
POA3318,122,238,1.950819672,70,276,1.942857143,29,85,1.931034483,99,361,3.646464646,20,54,1.7,8,13,0.625,28,67,2.392857143,3,4,1.333333333
POA3319,56,116,2.071428571,19,80,2.210526316,7,19,1.714285714,26,99,3.807692308,7,20,1.857142857,3,6,1,10,26,2.6,0,0,#DIV/0!
POA3321,121,239,1.975206612,119,494,2.151260504,56,178,2.178571429,175,672,3.84,14,40,1.857142857,16,34,1.125,30,74,2.466666667,0,0,#DIV/0!
POA3324,81,162,2,37,141,1.810810811,13,47,2.615384615,50,188,3.76,11,29,1.636363636,14,26,0.857142857,25,55,2.2,0,7,#DIV/0!
POA3325,79,145,1.835443038,40,153,1.825,11,39,2.545454545,51,192,3.764705882,12,30,1.5,3,17,4.666666667,15,47,3.133333333,0,4,#DIV/0!
POA3328,174,341,1.959770115,157,655,2.171974522,55,193,2.509090909,212,848,4,23,71,2.086956522,20,43,1.15,43,114,2.651162791,3,9,3
POA3329,29,60,2.068965517,37,146,1.945945946,10,43,3.3,47,189,4.021276596,4,11,1.75,3,4,0.333333333,7,15,2.142857143,0,0,#DIV/0!
POA3330,62,122,1.967741935,32,145,2.53125,18,57,2.166666667,50,202,4.04,8,31,2.875,10,14,0.4,18,45,2.5,3,9,3
POA3331,431,849,1.969837587,466,1946,2.175965665,159,540,2.396226415,625,2486,3.9776,58,159,1.74137931,44,102,1.318181818,102,261,2.558823529,6,14,2.333333333
POA3332,89,173,1.943820225,90,400,2.444444444,49,166,2.387755102,139,566,4.071942446,29,72,1.482758621,10,20,1,39,92,2.358974359,0,4,#DIV/0!
POA3333,83,162,1.951807229,65,288,2.430769231,20,69,2.45,85,357,4.2,17,40,1.352941176,6,18,2,23,58,2.52173913,4,7,1.75
POA3334,60,121,2.016666667,39,171,2.384615385,15,46,2.066666667,54,217,4.018518519,16,49,2.0625,7,18,1.571428571,23,67,2.913043478,4,6,1.5
POA3335,165,329,1.993939394,107,469,2.38317757,102,374,2.666666667,209,843,4.033492823,35,114,2.257142857,44,106,1.409090909,79,220,2.784810127,6,10,1.666666667
POA3337,2708,5426,2.003692762,2634,11060,2.198936978,1328,4548,2.424698795,3962,15608,3.939424533,1117,3449,2.087735004,741,1709,1.30634278,1858,5158,2.776103337,125,259,2.072
POA3338,1388,2774,1.998559078,1222,5038,2.122749591,606,2126,2.508250825,1828,7164,3.919037199,550,1641,1.983636364,389,910,1.33933162,939,2551,2.716719915,84,179,2.130952381
POA3340,1645,3273,1.989665653,1610,6685,2.152173913,774,2663,2.440568475,2384,9348,3.92114094,448,1330,1.96875,405,897,1.214814815,853,2227,2.610785463,58,128,2.206896552
POA3341,172,339,1.970930233,147,625,2.25170068,69,224,2.246376812,216,849,3.930555556,22,61,1.772727273,12,35,1.916666667,34,96,2.823529412,3,0,0
POA3342,373,724,1.941018767,262,1121,2.278625954,114,362,2.175438596,376,1483,3.944148936,71,203,1.85915493,62,138,1.225806452,133,341,2.563909774,0,3,#DIV/0!
POA3345,151,294,1.947019868,96,411,2.28125,61,197,2.229508197,157,608,3.872611465,25,70,1.8,26,54,1.076923077,51,124,2.431372549,3,3,1
POA3350,5288,10459,1.977874433,4067,16670,2.098844357,1586,5260,2.316519546,5653,21930,3.879356094,1399,3966,1.834882059,1082,2393,1.211645102,2481,6359,2.563079403,218,457,2.096330275
POA3351,859,1698,1.976717113,705,2981,2.228368794,319,1072,2.360501567,1024,4053,3.958007813,133,400,2.007518797,109,228,1.091743119,242,628,2.595041322,16,35,2.1875
POA3352,1584,3133,1.97790404,1383,5881,2.252349964,630,2092,2.320634921,2013,7973,3.960755092,214,647,2.023364486,186,415,1.231182796,400,1062,2.655,30,66,2.2
POA3355,1336,2643,1.978293413,757,3149,2.15984148,381,1255,2.293963255,1138,4404,3.869947276,490,1445,1.948979592,355,786,1.214084507,845,2231,2.640236686,53,104,1.962264151
POA3356,1329,2635,1.982693755,952,3949,2.148109244,403,1375,2.41191067,1355,5324,3.929151292,533,1596,1.994371482,343,771,1.247813411,876,2367,2.702054795,65,136,2.092307692
POA3357,377,736,1.952254642,300,1266,2.22,125,425,2.4,425,1691,3.978823529,62,170,1.741935484,37,91,1.459459459,99,261,2.636363636,9,16,1.777777778
POA3360,107,213,1.990654206,50,218,2.36,29,93,2.206896552,79,311,3.936708861,19,54,1.842105263,13,32,1.461538462,32,86,2.6875,7,10,1.428571429
POA3361,111,223,2.009009009,79,334,2.227848101,27,79,1.925925926,106,413,3.896226415,12,37,2.083333333,16,32,1,28,69,2.464285714,3,4,1.333333333
POA3363,368,724,1.967391304,224,947,2.227678571,120,403,2.358333333,344,1350,3.924418605,92,267,1.902173913,75,160,1.133333333,167,427,2.556886228,8,21,2.625
POA3364,280,552,1.971428571,172,736,2.279069767,72,232,2.222222222,244,968,3.967213115,22,61,1.772727273,26,56,1.153846154,48,117,2.4375,7,10,1.428571429
POA3370,211,423,2.004739336,89,394,2.426966292,52,161,2.096153846,141,555,3.936170213,63,176,1.793650794,36,81,1.25,99,257,2.595959596,9,14,1.555555556
POA3371,159,309,1.943396226,73,321,2.397260274,49,155,2.163265306,122,476,3.901639344,27,85,2.148148148,21,52,1.476190476,48,137,2.854166667,5,4,0.8
POA3373,248,488,1.967741935,111,471,2.243243243,54,158,1.925925926,165,629,3.812121212,36,98,1.722222222,43,83,0.930232558,79,181,2.291139241,0,4,#DIV/0!
POA3374,72,149,2.069444444,37,163,2.405405405,20,62,2.1,57,225,3.947368421,10,23,1.3,8,15,0.875,18,38,2.111111111,3,4,1.333333333
POA3375,39,80,2.051282051,22,90,2.090909091,7,17,1.428571429,29,107,3.689655172,4,5,0.25,4,11,1.75,8,16,2,0,3,#DIV/0!
POA3377,988,1955,1.978744939,588,2450,2.166666667,243,774,2.185185185,831,3224,3.879663057,230,662,1.87826087,141,305,1.163120567,371,967,2.606469003,28,53,1.892857143
POA3378,53,109,2.056603774,28,109,1.892857143,13,36,1.769230769,41,145,3.536585366,7,16,1.285714286,3,10,2.333333333,10,26,2.6,0,0,#DIV/0!
POA3379,74,148,2,38,167,2.394736842,19,53,1.789473684,57,220,3.859649123,13,43,2.307692308,10,20,1,23,63,2.739130435,0,0,#DIV/0!
POA3380,715,1406,1.966433566,422,1726,2.090047393,172,561,2.261627907,594,2287,3.85016835,154,432,1.805194805,128,272,1.125,282,704,2.496453901,26,55,2.115384615
POA3381,179,350,1.955307263,56,228,2.071428571,27,90,2.333333333,83,318,3.831325301,16,45,1.8125,12,26,1.166666667,28,71,2.535714286,3,4,1.333333333
POA3384,120,235,1.958333333,57,265,2.649122807,28,86,2.071428571,85,351,4.129411765,13,41,2.153846154,9,21,1.333333333,22,62,2.818181818,0,5,#DIV/0!
POA3385,92,175,1.902173913,44,191,2.340909091,21,62,1.952380952,65,253,3.892307692,8,33,3.125,10,18,0.8,18,51,2.833333333,0,0,#DIV/0!
POA3387,56,107,1.910714286,31,113,1.64516129,13,38,1.923076923,44,151,3.431818182,4,8,1,0,3,#DIV/0!,4,11,2.75,0,4,#DIV/0!
POA3388,70,141,2.014285714,37,152,2.108108108,22,73,2.318181818,59,225,3.813559322,10,31,2.1,10,21,1.1,20,52,2.6,3,3,1
POA3390,120,238,1.983333333,80,318,1.975,31,97,2.129032258,111,415,3.738738739,18,69,2.833333333,17,35,1.058823529,35,104,2.971428571,4,9,2.25
POA3391,35,65,1.857142857,23,94,2.086956522,9,27,2,32,121,3.78125,4,9,1.25,0,7,#DIV/0!,4,16,4,0,5,#DIV/0!
POA3392,82,165,2.012195122,47,193,2.106382979,15,55,2.666666667,62,248,4,10,30,2,14,28,1,24,58,2.416666667,4,3,0.75
POA3393,368,725,1.970108696,172,723,2.203488372,74,234,2.162162162,246,957,3.890243902,60,181,2.016666667,37,81,1.189189189,97,262,2.701030928,6,9,1.5
POA3395,90,175,1.944444444,48,207,2.3125,15,56,2.733333333,63,263,4.174603175,5,16,2.2,4,12,2,9,28,3.111111111,0,0,#DIV/0!
POA3396,79,163,2.063291139,28,126,2.5,17,50,1.941176471,45,176,3.911111111,6,15,1.5,11,18,0.636363636,17,33,1.941176471,5,11,2.2
POA3400,1652,3265,1.976392252,1059,4315,2.074598678,350,1135,2.242857143,1409,5450,3.867991483,420,1182,1.814285714,261,571,1.187739464,681,1753,2.574155653,54,115,2.12962963
POA3401,550,1091,1.983636364,441,1884,2.272108844,186,606,2.258064516,627,2490,3.971291866,57,180,2.157894737,43,94,1.186046512,100,274,2.74,7,18,2.571428571
POA3407,47,92,1.957446809,25,111,2.44,9,28,2.111111111,34,139,4.088235294,7,18,1.571428571,3,6,1,10,24,2.4,0,0,#DIV/0!
POA3409,146,287,1.965753425,76,316,2.157894737,36,120,2.333333333,112,436,3.892857143,18,49,1.722222222,16,29,0.8125,34,78,2.294117647,0,3,#DIV/0!
POA3412,40,80,2,17,46,0.705882353,3,15,4,20,61,3.05,5,15,2,6,9,0.5,11,24,2.181818182,0,0,#DIV/0!
POA3413,27,54,2,23,102,2.434782609,10,33,2.3,33,135,4.090909091,0,0,#DIV/0!,3,7,1.333333333,3,7,2.333333333,3,7,2.333333333
POA3414,211,417,1.976303318,107,450,2.205607477,55,166,2.018181818,162,616,3.802469136,40,121,2.025,39,81,1.076923077,79,202,2.556962025,7,14,2
POA3418,360,707,1.963888889,220,926,2.209090909,74,238,2.216216216,294,1164,3.959183673,40,127,2.175,46,94,1.043478261,86,221,2.569767442,18,43,2.388888889
POA3419,140,278,1.985714286,85,348,2.094117647,20,70,2.5,105,418,3.980952381,21,59,1.80952381,15,30,1,36,89,2.472222222,8,13,1.625
POA3420,28,57,2.035714286,28,126,2.5,12,34,1.833333333,40,160,4,4,10,1.5,5,17,2.4,9,27,3,3,3,1
POA3423,78,149,1.91025641,37,156,2.216216216,23,70,2.043478261,60,226,3.766666667,13,46,2.538461538,6,13,1.166666667,19,59,3.105263158,0,7,#DIV/0!
POA3424,96,192,2,50,210,2.2,24,68,1.833333333,74,278,3.756756757,13,32,1.461538462,8,18,1.25,21,50,2.380952381,3,3,1
POA3427,177,361,2.039548023,165,678,2.109090909,138,470,2.405797101,303,1148,3.788778878,64,177,1.765625,66,160,1.424242424,130,337,2.592307692,14,29,2.071428571
POA3428,63,124,1.968253968,48,204,2.25,38,126,2.315789474,86,330,3.837209302,18,55,2.055555556,14,33,1.357142857,32,88,2.75,3,3,1
POA3429,3045,6060,1.990147783,3203,13158,2.108023728,1624,5686,2.501231527,4827,18844,3.903874042,786,2306,1.933842239,754,1712,1.270557029,1540,4018,2.609090909,132,267,2.022727273
POA3430,47,92,1.957446809,37,144,1.891891892,19,68,2.578947368,56,212,3.785714286,3,12,3,8,16,1,11,28,2.545454545,3,3,1
POA3431,357,710,1.988795518,379,1581,2.171503958,206,719,2.490291262,585,2300,3.931623932,49,144,1.93877551,54,122,1.259259259,103,266,2.582524272,9,20,2.222222222
POA3433,29,58,2,34,147,2.323529412,11,41,2.727272727,45,188,4.177777778,0,13,#DIV/0!,3,0,-1,3,13,4.333333333,3,6,2
POA3434,445,883,1.984269663,439,1854,2.223234624,184,635,2.451086957,623,2489,3.995184591,85,281,2.305882353,59,132,1.237288136,144,413,2.868055556,5,7,1.4
POA3435,314,622,1.98089172,218,892,2.091743119,109,365,2.348623853,327,1257,3.844036697,53,150,1.830188679,54,111,1.055555556,107,261,2.439252336,4,16,4
POA3437,844,1669,1.977488152,872,3635,2.168577982,420,1417,2.373809524,1292,5052,3.910216718,135,381,1.822222222,136,314,1.308823529,271,695,2.564575646,11,20,1.818181818
POA3438,188,374,1.989361702,278,1172,2.215827338,90,317,2.522222222,368,1489,4.046195652,40,128,2.2,42,96,1.285714286,82,224,2.731707317,4,7,1.75
POA3440,207,398,1.922705314,169,714,2.224852071,97,320,2.298969072,266,1034,3.887218045,27,71,1.62962963,33,69,1.090909091,60,140,2.333333333,5,11,2.2
POA3441,181,356,1.966850829,101,434,2.297029703,69,222,2.217391304,170,656,3.858823529,19,50,1.631578947,21,43,1.047619048,40,93,2.325,0,0,#DIV/0!
POA3442,745,1473,1.977181208,684,2778,2.061403509,275,917,2.334545455,959,3695,3.852971846,131,375,1.86259542,104,232,1.230769231,235,607,2.582978723,15,31,2.066666667
POA3444,1015,2011,1.981280788,639,2651,2.148669797,289,975,2.373702422,928,3626,3.907327586,178,542,2.04494382,151,338,1.238410596,329,880,2.674772036,26,54,2.076923077
POA3446,62,121,1.951612903,48,169,1.520833333,17,59,2.470588235,65,228,3.507692308,17,49,1.882352941,15,35,1.333333333,32,84,2.625,0,4,#DIV/0!
POA3447,53,105,1.981132075,34,141,2.147058824,16,47,1.9375,50,188,3.76,17,42,1.470588235,12,26,1.166666667,29,68,2.344827586,0,0,#DIV/0!
POA3448,96,190,1.979166667,47,180,1.829787234,26,89,2.423076923,73,269,3.684931507,13,33,1.538461538,12,27,1.25,25,60,2.4,0,0,#DIV/0!
POA3450,753,1487,1.974767596,414,1691,2.084541063,175,595,2.4,589,2286,3.881154499,204,526,1.578431373,170,348,1.047058824,374,874,2.336898396,35,73,2.085714286
POA3451,526,1024,1.946768061,341,1398,2.099706745,177,563,2.18079096,518,1961,3.785714286,94,254,1.70212766,86,187,1.174418605,180,441,2.45,13,20,1.538461538
POA3453,201,398,1.980099502,116,501,2.318965517,60,203,2.383333333,176,704,4,31,89,1.870967742,22,45,1.045454545,53,134,2.528301887,3,6,2
POA3458,224,431,1.924107143,123,488,1.967479675,45,161,2.577777778,168,649,3.863095238,23,58,1.52173913,33,67,1.03030303,56,125,2.232142857,7,12,1.714285714
POA3460,310,612,1.974193548,137,534,1.897810219,49,159,2.244897959,186,693,3.725806452,84,221,1.630952381,66,136,1.060606061,150,357,2.38,13,21,1.615384615
POA3461,530,1015,1.91509434,260,1064,2.092307692,117,387,2.307692308,377,1451,3.848806366,87,231,1.655172414,59,122,1.06779661,146,353,2.417808219,11,22,2
POA3462,132,264,2,61,257,2.213114754,34,102,2,95,359,3.778947368,18,57,2.166666667,17,31,0.823529412,35,88,2.514285714,0,3,#DIV/0!
POA3463,417,837,2.007194245,174,707,2.063218391,91,284,2.120879121,265,991,3.739622642,51,139,1.725490196,52,116,1.230769231,103,255,2.475728155,8,10,1.25
POA3464,137,266,1.941605839,91,375,2.120879121,38,132,2.473684211,129,507,3.930232558,16,61,2.8125,23,46,1,39,107,2.743589744,3,4,1.333333333
POA3465,1066,2118,1.986866792,505,2128,2.213861386,271,857,2.162361624,776,2985,3.846649485,269,787,1.925650558,193,405,1.098445596,462,1192,2.58008658,39,76,1.948717949
POA3467,176,347,1.971590909,84,345,2.107142857,33,110,2.333333333,117,455,3.888888889,34,84,1.470588235,16,37,1.3125,50,121,2.42,4,5,1.25
POA3468,23,49,2.130434783,16,81,3.0625,9,26,1.888888889,25,107,4.28,6,7,0.166666667,4,7,0.75,10,14,1.4,3,3,1
POA3469,75,141,1.88,28,129,2.607142857,6,15,1.5,34,144,4.235294118,4,13,2.25,3,6,1,7,19,2.714285714,0,7,#DIV/0!
POA3472,229,446,1.947598253,69,286,2.144927536,23,83,2.608695652,92,369,4.010869565,31,105,2.387096774,21,46,1.19047619,52,151,2.903846154,5,9,1.8
POA3475,30,60,2,16,75,2.6875,19,55,1.894736842,35,130,3.714285714,0,8,#DIV/0!,11,16,0.454545455,11,24,2.181818182,0,0,#DIV/0!
POA3477,61,129,2.114754098,28,119,2.25,12,38,2.166666667,40,157,3.925,6,14,1.333333333,12,19,0.583333333,18,33,1.833333333,0,4,#DIV/0!
POA3478,402,791,1.967661692,214,875,2.088785047,79,248,2.139240506,293,1123,3.832764505,67,187,1.791044776,44,96,1.181818182,111,283,2.54954955,12,26,2.166666667
POA3480,230,446,1.939130435,123,556,2.520325203,44,147,2.340909091,167,703,4.209580838,25,82,2.28,18,40,1.222222222,43,122,2.837209302,0,3,#DIV/0!
POA3482,41,80,1.951219512,42,200,2.761904762,24,74,2.083333333,66,274,4.151515152,5,11,1.2,3,11,2.666666667,8,22,2.75,3,4,1.333333333
POA3483,86,161,1.872093023,50,220,2.4,16,54,2.375,66,274,4.151515152,8,17,1.125,12,29,1.416666667,20,46,2.3,0,0,#DIV/0!
POA3485,32,63,1.96875,10,46,2.6,6,15,1.5,16,61,3.8125,4,17,3.25,0,0,#DIV/0!,4,17,4.25,0,3,#DIV/0!
POA3490,129,259,2.007751938,71,305,2.295774648,34,106,2.117647059,105,411,3.914285714,16,49,2.0625,16,34,1.125,32,83,2.59375,0,3,#DIV/0!
POA3491,51,106,2.078431373,36,155,2.305555556,12,44,2.666666667,48,199,4.145833333,6,10,0.666666667,7,14,1,13,24,1.846153846,0,4,#DIV/0!
POA3494,66,124,1.878787879,58,245,2.224137931,19,57,2,77,302,3.922077922,9,27,2,4,9,1.25,13,36,2.769230769,3,12,4
POA3496,602,1177,1.955149502,458,1959,2.277292576,223,719,2.224215247,681,2678,3.932452276,141,434,2.078014184,105,235,1.238095238,246,669,2.719512195,16,32,2
POA3498,492,983,1.99796748,455,1956,2.298901099,204,699,2.426470588,659,2655,4.028831563,99,277,1.797979798,73,156,1.136986301,172,433,2.51744186,15,26,1.733333333
POA3500,3193,6301,1.973379267,2205,9130,2.140589569,777,2508,2.227799228,2982,11638,3.902749832,1061,3235,2.049010368,614,1376,1.241042345,1675,4611,2.752835821,117,248,2.11965812
POA3501,202,404,2,205,887,2.326829268,77,251,2.25974026,282,1138,4.035460993,20,61,2.05,28,63,1.25,48,124,2.583333333,4,3,0.75
POA3505,536,1061,1.979477612,348,1494,2.293103448,177,597,2.372881356,525,2091,3.982857143,137,418,2.051094891,92,200,1.173913043,229,618,2.698689956,9,20,2.222222222
POA3507,48,100,2.083333333,35,158,2.514285714,22,72,2.272727273,57,230,4.035087719,7,19,1.714285714,6,10,0.666666667,13,29,2.230769231,3,5,1.666666667
POA3509,34,63,1.852941176,19,68,1.578947368,6,12,1,25,80,3.2,0,13,#DIV/0!,3,9,2,3,22,7.333333333,3,5,1.666666667
POA3512,91,170,1.868131868,38,151,1.973684211,13,41,2.153846154,51,192,3.764705882,3,12,3,9,15,0.666666667,12,27,2.25,0,5,#DIV/0!
POA3515,94,185,1.968085106,87,344,1.954022989,49,167,2.408163265,136,511,3.757352941,14,38,1.714285714,10,17,0.7,24,55,2.291666667,3,7,2.333333333
POA3516,97,195,2.010309278,60,260,2.333333333,29,102,2.517241379,89,362,4.06741573,16,48,2,11,25,1.272727273,27,73,2.703703704,3,5,1.666666667
POA3517,221,435,1.968325792,86,362,2.209302326,42,132,2.142857143,128,494,3.859375,30,94,2.133333333,21,42,1,51,136,2.666666667,4,8,2
POA3518,180,349,1.938888889,65,291,2.476923077,35,112,2.2,100,403,4.03,30,79,1.633333333,30,64,1.133333333,60,143,2.383333333,9,15,1.666666667
POA3520,36,73,2.027777778,11,48,2.363636364,7,15,1.142857143,18,63,3.5,7,19,1.714285714,4,13,2.25,11,32,2.909090909,4,4,1
POA3521,70,139,1.985714286,62,270,2.35483871,30,105,2.5,92,375,4.076086957,15,53,2.533333333,14,24,0.714285714,29,77,2.655172414,6,8,1.333333333
POA3522,60,122,2.033333333,32,136,2.25,14,43,2.071428571,46,179,3.891304348,8,30,2.75,3,6,1,11,36,3.272727273,0,0,#DIV/0!
POA3523,527,1034,1.962049336,171,735,2.298245614,113,350,2.097345133,284,1085,3.820422535,74,217,1.932432432,65,138,1.123076923,139,355,2.553956835,19,39,2.052631579
POA3525,193,380,1.968911917,73,326,2.465753425,47,147,2.127659574,120,473,3.941666667,11,46,3.181818182,25,49,0.96,36,95,2.638888889,4,7,1.75
POA3527,111,215,1.936936937,50,205,2.1,24,77,2.208333333,74,282,3.810810811,12,36,2,11,19,0.727272727,23,55,2.391304348,3,7,2.333333333
POA3530,33,69,2.090909091,28,136,2.857142857,15,42,1.8,43,178,4.139534884,0,7,#DIV/0!,4,0,-1,4,7,1.75,0,7,#DIV/0!
POA3531,36,68,1.888888889,32,135,2.21875,11,30,1.727272727,43,165,3.837209302,5,17,2.4,3,7,1.333333333,8,24,3,0,3,#DIV/0!
POA3533,107,216,2.018691589,57,255,2.473684211,28,82,1.928571429,85,337,3.964705882,19,50,1.631578947,12,25,1.083333333,31,75,2.419354839,3,10,3.333333333
POA3537,176,351,1.994318182,85,382,2.494117647,31,84,1.709677419,116,466,4.017241379,9,32,2.555555556,16,26,0.625,25,58,2.32,3,8,2.666666667
POA3540,43,91,2.11627907,25,113,2.52,7,29,3.142857143,32,142,4.4375,12,35,1.916666667,4,6,0.5,16,41,2.5625,0,0,#DIV/0!
POA3542,28,54,1.928571429,23,92,2,11,30,1.727272727,34,122,3.588235294,3,11,2.666666667,0,3,#DIV/0!,3,14,4.666666667,0,0,#DIV/0!
POA3544,34,66,1.941176471,31,131,2.225806452,11,39,2.545454545,42,170,4.047619048,10,27,1.7,0,4,#DIV/0!,10,31,3.1,0,0,#DIV/0!
POA3546,55,111,2.018181818,33,145,2.393939394,19,55,1.894736842,52,200,3.846153846,11,43,2.909090909,3,9,2,14,52,3.714285714,0,6,#DIV/0!
POA3549,366,748,2.043715847,285,1256,2.407017544,91,312,2.428571429,376,1568,4.170212766,91,294,2.230769231,56,114,1.035714286,147,408,2.775510204,20,60,3
POA3550,3941,7761,1.969297133,2624,10775,2.10632622,1096,3643,2.323905109,3720,14418,3.875806452,1190,3397,1.854621849,943,2054,1.178154825,2133,5451,2.555555556,196,406,2.071428571
POA3551,2505,4950,1.976047904,2586,10788,2.171693735,977,3256,2.332650972,3563,14044,3.941622228,406,1185,1.918719212,283,630,1.22614841,689,1815,2.63425254,57,111,1.947368421
POA3555,1978,3931,1.987360971,1243,5107,2.108608206,569,1870,2.286467487,1812,6977,3.850441501,606,1715,1.830033003,465,1047,1.251612903,1071,2762,2.578898226,88,186,2.113636364
POA3556,1097,2177,1.984503191,764,3134,2.102094241,358,1195,2.337988827,1122,4329,3.85828877,436,1311,2.006880734,289,633,1.190311419,725,1944,2.68137931,52,102,1.961538462
POA3557,68,141,2.073529412,61,263,2.31147541,24,71,1.958333333,85,334,3.929411765,11,28,1.545454545,8,14,0.75,19,42,2.210526316,0,4,#DIV/0!
POA3558,129,253,1.96124031,61,252,2.131147541,31,104,2.35483871,92,356,3.869565217,25,68,1.72,16,36,1.25,41,104,2.536585366,0,7,#DIV/0!
POA3559,91,181,1.989010989,40,181,2.525,23,78,2.391304348,63,259,4.111111111,10,26,1.6,7,17,1.428571429,17,43,2.529411765,4,7,1.75
POA3561,603,1195,1.981757877,372,1617,2.346774194,156,490,2.141025641,528,2107,3.990530303,86,274,2.186046512,72,152,1.111111111,158,426,2.696202532,12,22,1.833333333
POA3562,29,57,1.965517241,25,107,2.28,7,28,3,32,135,4.21875,6,20,2.333333333,4,5,0.25,10,25,2.5,0,4,#DIV/0!
POA3563,83,165,1.987951807,58,264,2.551724138,32,99,2.09375,90,363,4.033333333,25,72,1.88,13,29,1.230769231,38,101,2.657894737,0,0,#DIV/0!
POA3564,1741,3447,1.979896611,1174,4848,2.129471891,428,1381,2.226635514,1602,6229,3.888264669,431,1229,1.851508121,271,589,1.173431734,702,1818,2.58974359,52,104,2
POA3566,71,134,1.887323944,46,204,2.434782609,17,58,2.411764706,63,262,4.158730159,4,22,4.5,7,10,0.428571429,11,32,2.909090909,0,3,#DIV/0!
POA3567,80,161,2.0125,59,253,2.288135593,16,50,2.125,75,303,4.04,3,14,3.666666667,11,16,0.454545455,14,30,2.142857143,0,0,#DIV/0!
POA3568,410,809,1.973170732,196,831,2.239795918,78,256,2.282051282,274,1087,3.967153285,49,145,1.959183673,43,90,1.093023256,92,235,2.554347826,3,16,5.333333333
POA3570,74,148,2,47,201,2.276595745,26,86,2.307692308,73,287,3.931506849,10,32,2.2,12,26,1.166666667,22,58,2.636363636,0,3,#DIV/0!
POA3571,37,74,2,31,127,2.096774194,6,20,2.333333333,37,147,3.972972973,8,16,1,5,12,1.4,13,28,2.153846154,0,0,#DIV/0!
POA3572,18,36,2,20,95,2.75,10,35,2.5,30,130,4.333333333,0,0,#DIV/0!,0,3,#DIV/0!,0,3,#DIV/0!,0,0,#DIV/0!
POA3573,67,132,1.970149254,44,194,2.409090909,18,52,1.888888889,62,246,3.967741935,9,25,1.777777778,3,8,1.666666667,12,33,2.75,4,8,2
POA3575,93,185,1.989247312,62,265,2.274193548,26,78,2,88,343,3.897727273,25,64,1.56,10,23,1.3,35,87,2.485714286,0,0,#DIV/0!
POA3579,657,1300,1.97869102,356,1566,2.398876404,149,491,2.295302013,505,2057,4.073267327,106,312,1.943396226,90,189,1.1,196,501,2.556122449,20,33,1.65
POA3580,126,247,1.96031746,41,172,2.195121951,21,66,2.142857143,62,238,3.838709677,19,51,1.684210526,12,21,0.75,31,72,2.322580645,0,3,#DIV/0!
POA3581,26,51,1.961538462,34,147,2.323529412,12,37,2.083333333,46,184,4,6,16,1.666666667,0,4,#DIV/0!,6,20,3.333333333,0,0,#DIV/0!
POA3584,172,338,1.965116279,103,451,2.378640777,42,131,2.119047619,145,582,4.013793103,27,75,1.777777778,17,35,1.058823529,44,110,2.5,6,9,1.5
POA3585,1190,2354,1.978151261,809,3376,2.173053152,283,906,2.201413428,1092,4282,3.921245421,291,891,2.06185567,150,324,1.16,441,1215,2.755102041,55,114,2.072727273
POA3586,85,169,1.988235294,71,311,2.38028169,34,103,2.029411765,105,414,3.942857143,7,27,2.857142857,10,17,0.7,17,44,2.588235294,0,0,#DIV/0!
POA3588,37,81,2.189189189,26,103,1.961538462,12,38,2.166666667,38,141,3.710526316,9,26,1.888888889,3,5,0.666666667,12,31,2.583333333,3,3,1
POA3589,33,72,2.181818182,36,170,2.722222222,19,59,2.105263158,55,229,4.163636364,4,12,2,0,3,#DIV/0!,4,15,3.75,0,3,#DIV/0!
POA3590,50,96,1.92,36,144,2,14,44,2.142857143,50,188,3.76,5,15,2,4,8,1,9,23,2.555555556,0,3,#DIV/0!
POA3591,34,65,1.911764706,26,98,1.769230769,16,53,2.3125,42,151,3.595238095,3,4,0.333333333,3,7,1.333333333,6,11,1.833333333,0,0,#DIV/0!
POA3594,65,133,2.046153846,34,146,2.294117647,13,37,1.846153846,47,183,3.893617021,10,35,2.5,6,9,0.5,16,44,2.75,3,0,0
POA3595,59,124,2.101694915,50,190,1.8,21,69,2.285714286,71,259,3.647887324,21,83,2.952380952,15,26,0.733333333,36,109,3.027777778,3,4,1.333333333
POA3596,14,30,2.142857143,12,55,2.583333333,5,18,2.6,17,73,4.294117647,0,8,#DIV/0!,3,3,0,3,11,3.666666667,0,0,#DIV/0!
POA3597,58,115,1.982758621,55,234,2.254545455,22,68,2.090909091,77,302,3.922077922,8,18,1.25,6,19,2.166666667,14,37,2.642857143,0,3,#DIV/0!
POA3608,311,613,1.971061093,136,546,2.014705882,69,232,2.362318841,205,778,3.795121951,43,132,2.069767442,49,109,1.224489796,92,241,2.619565217,3,6,2
POA3610,179,343,1.916201117,116,487,2.198275862,49,161,2.285714286,165,648,3.927272727,31,114,2.677419355,21,41,0.952380952,52,155,2.980769231,3,13,4.333333333
POA3612,238,467,1.962184874,98,423,2.316326531,42,139,2.30952381,140,562,4.014285714,29,100,2.448275862,37,74,1,66,174,2.636363636,6,11,1.833333333
POA3614,84,168,2,81,339,2.185185185,29,93,2.206896552,110,432,3.927272727,11,30,1.727272727,9,23,1.555555556,20,53,2.65,3,4,1.333333333
POA3616,592,1180,1.993243243,379,1626,2.290237467,193,658,2.409326425,572,2284,3.993006993,113,355,2.14159292,91,206,1.263736264,204,561,2.75,16,33,2.0625
POA3617,37,73,1.972972973,24,102,2.25,16,48,2,40,150,3.75,3,11,2.666666667,7,13,0.857142857,10,24,2.4,3,3,1
POA3618,75,143,1.906666667,57,240,2.210526316,30,100,2.333333333,87,340,3.908045977,14,32,1.285714286,12,22,0.833333333,26,54,2.076923077,0,0,#DIV/0!
POA3620,910,1801,1.979120879,602,2580,2.285714286,248,816,2.290322581,850,3396,3.995294118,216,635,1.939814815,141,308,1.184397163,357,943,2.641456583,25,53,2.12
POA3621,244,486,1.991803279,164,730,2.451219512,74,239,2.22972973,238,969,4.071428571,51,168,2.294117647,42,89,1.119047619,93,257,2.76344086,3,11,3.666666667
POA3622,45,92,2.044444444,27,112,2.148148148,8,31,2.875,35,143,4.085714286,6,24,3,11,27,1.454545455,17,51,3,0,0,#DIV/0!
POA3623,134,266,1.985074627,51,213,2.176470588,43,147,2.418604651,94,360,3.829787234,18,49,1.722222222,14,36,1.571428571,32,85,2.65625,4,8,2
POA3624,77,157,2.038961039,50,216,2.32,19,63,2.315789474,69,279,4.043478261,12,24,1,9,21,1.333333333,21,45,2.142857143,0,0,#DIV/0!
POA3629,893,1759,1.969764838,689,2881,2.181422351,259,833,2.216216216,948,3714,3.917721519,300,925,2.083333333,193,438,1.269430052,493,1363,2.764705882,32,71,2.21875
POA3630,2714,5396,1.988209285,2225,9507,2.272808989,812,2717,2.346059113,3037,12224,4.025024695,998,3050,2.056112224,570,1276,1.238596491,1568,4326,2.758928571,102,219,2.147058824
POA3631,1081,2145,1.984273821,955,4086,2.278534031,459,1526,2.324618736,1414,5612,3.968882603,143,414,1.895104895,114,252,1.210526316,257,666,2.591439689,18,42,2.333333333
POA3633,70,142,2.028571429,61,267,2.37704918,34,101,1.970588235,95,368,3.873684211,10,28,1.8,3,8,1.666666667,13,36,2.769230769,3,3,1
POA3634,190,378,1.989473684,166,694,2.180722892,91,295,2.241758242,257,989,3.848249027,25,74,1.96,21,45,1.142857143,46,119,2.586956522,3,3,1
POA3635,74,139,1.878378378,39,179,2.58974359,36,124,2.444444444,75,303,4.04,11,34,2.090909091,9,20,1.222222222,20,54,2.7,3,7,2.333333333
POA3636,652,1292,1.981595092,411,1761,2.284671533,164,541,2.298780488,575,2302,4.003478261,123,367,1.983739837,85,179,1.105882353,208,546,2.625,8,14,1.75
POA3637,80,157,1.9625,69,308,2.463768116,20,69,2.45,89,377,4.235955056,12,27,1.25,3,9,2,15,36,2.4,4,3,0.75
POA3638,239,480,2.008368201,142,659,2.64084507,58,181,2.120689655,200,840,4.2,42,125,1.976190476,32,69,1.15625,74,194,2.621621622,9,18,2
POA3639,87,166,1.908045977,17,80,2.705882353,22,67,2.045454545,39,147,3.769230769,8,30,2.75,10,22,1.2,18,52,2.888888889,3,6,2
POA3640,127,248,1.952755906,120,522,2.35,41,131,2.195121951,161,653,4.055900621,21,51,1.428571429,12,26,1.166666667,33,77,2.333333333,4,7,1.75
POA3641,134,255,1.902985075,97,407,2.195876289,22,74,2.363636364,119,481,4.042016807,26,79,2.038461538,9,28,2.111111111,35,107,3.057142857,3,4,1.333333333
POA3644,1079,2139,1.982391103,636,2726,2.286163522,262,851,2.248091603,898,3577,3.983296214,220,659,1.995454545,123,272,1.211382114,343,931,2.714285714,26,54,2.076923077
POA3646,103,196,1.902912621,66,276,2.181818182,29,88,2.034482759,95,364,3.831578947,6,27,3.5,14,28,1,20,55,2.75,3,9,3
POA3649,60,123,2.05,33,150,2.545454545,15,43,1.866666667,48,193,4.020833333,10,40,3,6,13,1.166666667,16,53,3.3125,3,5,1.666666667
POA3658,610,1196,1.960655738,461,1878,2.073752711,223,757,2.394618834,684,2635,3.852339181,141,415,1.943262411,137,307,1.240875912,278,722,2.597122302,14,30,2.142857143
POA3659,102,210,2.058823529,66,267,2.045454545,29,93,2.206896552,95,360,3.789473684,6,17,1.833333333,16,30,0.875,22,47,2.136363636,4,3,0.75
POA3660,802,1589,1.981296758,435,1829,2.204597701,236,762,2.228813559,671,2591,3.861400894,235,715,2.042553191,184,393,1.135869565,419,1108,2.644391408,31,69,2.225806452
POA3662,65,127,1.953846154,171,668,1.906432749,15,42,1.8,186,710,3.817204301,10,27,1.7,0,6,#DIV/0!,10,33,3.3,0,0,#DIV/0!
POA3663,27,56,2.074074074,11,44,2,18,48,1.666666667,29,92,3.172413793,4,9,1.25,0,4,#DIV/0!,4,13,3.25,0,0,#DIV/0!
POA3664,128,257,2.0078125,75,290,1.866666667,47,140,1.978723404,122,430,3.524590164,20,57,1.85,23,40,0.739130435,43,97,2.255813953,0,0,#DIV/0!
POA3666,738,1445,1.95799458,279,1183,2.240143369,150,469,2.126666667,429,1652,3.850815851,94,271,1.882978723,87,186,1.137931034,181,457,2.524861878,17,30,1.764705882
POA3669,153,299,1.954248366,63,272,2.317460317,24,77,2.208333333,87,349,4.011494253,17,43,1.529411765,27,53,0.962962963,44,96,2.181818182,4,8,2
POA3670,96,190,1.979166667,39,173,2.435897436,37,120,2.243243243,76,293,3.855263158,13,37,1.846153846,11,20,0.818181818,24,57,2.375,0,0,#DIV/0!
POA3672,1279,2531,1.978889758,626,2614,2.17571885,316,1033,2.268987342,942,3647,3.871549894,303,894,1.95049505,224,477,1.129464286,527,1371,2.601518027,31,64,2.064516129
POA3673,262,518,1.977099237,114,477,2.184210526,57,183,2.210526316,171,660,3.859649123,12,39,2.25,19,39,1.052631579,31,78,2.516129032,0,3,#DIV/0!
POA3675,223,441,1.977578475,130,545,2.192307692,52,164,2.153846154,182,709,3.895604396,29,80,1.75862069,13,29,1.230769231,42,109,2.595238095,0,3,#DIV/0!
POA3677,1790,3561,1.989385475,1229,5110,2.157851912,499,1640,2.286573146,1728,6750,3.90625,489,1426,1.916155419,392,862,1.198979592,881,2288,2.597048808,70,141,2.014285714
POA3678,847,1670,1.971664699,520,2216,2.261538462,312,976,2.128205128,832,3192,3.836538462,62,193,2.112903226,91,197,1.164835165,153,390,2.549019608,17,33,1.941176471
POA3682,73,141,1.931506849,63,274,2.349206349,23,72,2.130434783,86,346,4.023255814,11,32,1.909090909,8,25,2.125,19,57,3,3,8,2.666666667
POA3683,212,412,1.943396226,122,491,2.024590164,57,171,2,179,662,3.698324022,32,97,2.03125,29,68,1.344827586,61,165,2.704918033,3,5,1.666666667
POA3685,307,597,1.944625407,188,761,2.04787234,83,260,2.13253012,271,1021,3.767527675,59,161,1.728813559,47,97,1.063829787,106,258,2.433962264,9,25,2.777777778
POA3687,104,209,2.009615385,67,284,2.23880597,24,77,2.208333333,91,361,3.967032967,24,75,2.125,5,18,2.6,29,93,3.206896552,3,5,1.666666667
POA3688,139,275,1.978417266,121,502,2.148760331,49,168,2.428571429,170,670,3.941176471,24,62,1.583333333,13,38,1.923076923,37,100,2.702702703,3,3,1
POA3690,3076,6065,1.971716515,2442,9957,2.077395577,907,2980,2.285556781,3349,12937,3.862944162,1087,3113,1.863845446,608,1320,1.171052632,1695,4433,2.615339233,116,233,2.00862069
POA3691,873,1699,1.946162658,821,3433,2.181485993,335,1105,2.298507463,1156,4538,3.925605536,117,346,1.957264957,84,176,1.095238095,201,522,2.597014925,9,14,1.555555556
POA3694,49,92,1.87755102,40,173,2.325,4,12,2,44,185,4.204545455,13,37,1.846153846,6,10,0.666666667,19,47,2.473684211,0,0,#DIV/0!
POA3695,61,122,2,38,173,2.552631579,18,52,1.888888889,56,225,4.017857143,4,22,4.5,5,10,1,9,32,3.555555556,3,0,0
POA3697,93,186,2,44,178,2.045454545,25,78,2.12,69,256,3.710144928,6,15,1.5,4,6,0.5,10,21,2.1,0,0,#DIV/0!
POA3698,118,242,2.050847458,65,265,2.076923077,21,56,1.666666667,86,321,3.73255814,11,31,1.818181818,11,17,0.545454545,22,48,2.181818182,0,0,#DIV/0!
POA3699,100,193,1.93,52,194,1.730769231,11,41,2.727272727,63,235,3.73015873,26,73,1.807692308,19,41,1.157894737,45,114,2.533333333,5,8,1.6
POA3700,151,288,1.907284768,73,309,2.232876712,30,96,2.2,103,405,3.932038835,35,92,1.628571429,21,47,1.238095238,56,139,2.482142857,3,15,5
POA3701,167,327,1.958083832,92,402,2.369565217,29,86,1.965517241,121,488,4.033057851,9,35,2.888888889,13,20,0.538461538,22,55,2.5,0,0,#DIV/0!
POA3705,77,147,1.909090909,28,125,2.464285714,12,37,2.083333333,40,162,4.05,0,4,#DIV/0!,7,13,0.857142857,7,17,2.428571429,0,3,#DIV/0!
POA3707,233,451,1.935622318,120,488,2.066666667,48,149,2.104166667,168,637,3.791666667,23,67,1.913043478,26,53,1.038461538,49,120,2.448979592,4,12,3
POA3709,54,100,1.851851852,15,69,2.6,6,18,2,21,87,4.142857143,6,14,1.333333333,6,13,1.166666667,12,27,2.25,0,8,#DIV/0!
POA3711,29,62,2.137931034,16,58,1.625,12,37,2.083333333,28,95,3.392857143,3,7,1.333333333,3,9,2,6,16,2.666666667,0,0,#DIV/0!
POA3712,50,97,1.94,19,82,2.315789474,12,24,1,31,106,3.419354839,11,26,1.363636364,7,9,0.285714286,18,35,1.944444444,0,0,#DIV/0!
POA3713,142,279,1.964788732,50,209,2.18,11,34,2.090909091,61,243,3.983606557,19,46,1.421052632,14,28,1,33,74,2.242424242,0,0,#DIV/0!
POA3714,470,923,1.963829787,216,865,2.00462963,111,358,2.225225225,327,1223,3.740061162,55,153,1.781818182,62,127,1.048387097,117,280,2.393162393,4,16,4
POA3715,56,109,1.946428571,20,73,1.65,4,24,5,24,97,4.041666667,0,9,#DIV/0!,4,6,0.5,4,15,3.75,0,3,#DIV/0!
POA3717,392,761,1.941326531,179,741,2.139664804,77,224,1.909090909,256,965,3.76953125,56,148,1.642857143,35,84,1.4,91,232,2.549450549,7,16,2.285714286
POA3719,85,169,1.988235294,40,170,2.25,14,52,2.714285714,54,222,4.111111111,6,15,1.5,7,14,1,13,29,2.230769231,0,3,#DIV/0!
POA3720,73,142,1.945205479,36,148,2.111111111,16,48,2,52,196,3.769230769,13,29,1.230769231,4,12,2,17,41,2.411764706,0,4,#DIV/0!
POA3722,508,994,1.956692913,307,1296,2.221498371,136,447,2.286764706,443,1743,3.934537246,113,301,1.663716814,75,154,1.053333333,188,455,2.420212766,13,31,2.384615385
POA3723,398,776,1.949748744,158,628,1.974683544,50,151,2.02,208,779,3.745192308,29,82,1.827586207,34,69,1.029411765,63,151,2.396825397,4,7,1.75
POA3725,54,100,1.851851852,25,93,1.72,18,54,2,43,147,3.418604651,7,29,3.142857143,0,8,#DIV/0!,7,37,5.285714286,0,3,#DIV/0!
POA3726,124,241,1.943548387,65,263,2.046153846,30,103,2.433333333,95,366,3.852631579,12,37,2.083333333,10,25,1.5,22,62,2.818181818,0,0,#DIV/0!
POA3727,48,102,2.125,27,124,2.592592593,19,50,1.631578947,46,174,3.782608696,6,19,2.166666667,3,3,0,9,22,2.444444444,0,0,#DIV/0!
POA3728,69,141,2.043478261,43,160,1.720930233,19,59,2.105263158,62,219,3.532258065,18,59,2.277777778,12,16,0.333333333,30,75,2.5,0,6,#DIV/0!
POA3730,1094,2166,1.979890311,549,2298,2.18579235,197,641,2.253807107,746,2939,3.939678284,150,440,1.933333333,127,267,1.102362205,277,707,2.55234657,27,55,2.037037037
POA3732,57,101,1.771929825,35,141,2.028571429,11,44,3,46,185,4.02173913,13,38,1.923076923,0,9,#DIV/0!,13,47,3.615384615,4,5,1.25
POA3733,77,146,1.896103896,22,102,2.636363636,21,59,1.80952381,43,161,3.744186047,3,10,2.333333333,10,16,0.6,13,26,2,0,3,#DIV/0!
POA3735,61,124,2.032786885,43,185,2.302325581,26,86,2.307692308,69,271,3.927536232,7,19,1.714285714,7,18,1.571428571,14,37,2.642857143,3,0,0
POA3737,562,1112,1.978647687,301,1273,2.22923588,141,469,2.326241135,442,1742,3.941176471,88,236,1.681818182,60,131,1.183333333,148,367,2.47972973,7,15,2.142857143
POA3739,65,124,1.907692308,22,91,2.136363636,14,49,2.5,36,140,3.888888889,9,20,1.222222222,6,11,0.833333333,15,31,2.066666667,0,0,#DIV/0!
POA3740,122,243,1.991803279,84,344,2.095238095,32,95,1.96875,116,439,3.784482759,17,40,1.352941176,13,27,1.076923077,30,67,2.233333333,3,3,1
POA3741,434,839,1.933179724,188,776,2.127659574,81,246,2.037037037,269,1022,3.799256506,61,154,1.524590164,29,70,1.413793103,90,224,2.488888889,6,13,2.166666667
POA3744,30,59,1.966666667,28,112,2,9,24,1.666666667,37,136,3.675675676,6,19,2.166666667,4,8,1,10,27,2.7,0,0,#DIV/0!
POA3746,38,78,2.052631579,10,50,3,10,23,1.3,20,73,3.65,3,7,1.333333333,0,7,#DIV/0!,3,14,4.666666667,0,0,#DIV/0!
POA3747,526,1042,1.980988593,279,1136,2.071684588,122,386,2.163934426,401,1522,3.795511222,95,254,1.673684211,89,182,1.04494382,184,436,2.369565217,11,21,1.909090909
POA3749,208,404,1.942307692,153,667,2.359477124,82,272,2.317073171,235,939,3.995744681,35,99,1.828571429,14,32,1.285714286,49,131,2.673469388,4,0,0
POA3750,69,150,2.173913043,41,159,1.87804878,32,113,2.53125,73,272,3.726027397,6,19,2.166666667,8,22,1.75,14,41,2.928571429,4,3,0.75
POA3751,37,71,1.918918919,15,80,3.333333333,26,84,2.230769231,41,164,4,11,25,1.272727273,11,26,1.363636364,22,51,2.318181818,0,3,#DIV/0!
POA3752,1361,2720,1.998530492,2540,10288,2.050393701,845,3016,2.569230769,3385,13304,3.93028065,460,1346,1.926086957,367,871,1.373297003,827,2217,2.680773881,67,150,2.23880597
POA3753,78,164,2.102564103,73,323,2.424657534,64,223,2.484375,137,546,3.98540146,15,39,1.6,10,22,1.2,25,61,2.44,0,0,#DIV/0!
POA3754,1586,3150,1.986128625,2315,9248,1.994816415,518,1813,2.5,2833,11061,3.904341687,365,1077,1.950684932,211,510,1.417061611,576,1587,2.755208333,58,115,1.982758621
POA3755,32,62,1.9375,22,104,2.727272727,21,60,1.857142857,43,164,3.813953488,6,9,0.5,5,11,1.2,11,20,1.818181818,0,0,#DIV/0!
POA3756,741,1475,1.990553306,947,3991,2.21436114,367,1266,2.449591281,1314,5257,4.000761035,247,764,2.093117409,146,318,1.178082192,393,1082,2.753180662,21,42,2
POA3757,703,1388,1.974395448,770,3180,2.12987013,368,1280,2.47826087,1138,4460,3.919156415,157,465,1.961783439,140,312,1.228571429,297,777,2.616161616,22,39,1.772727273
POA3758,189,370,1.957671958,216,926,2.287037037,114,419,2.675438596,330,1345,4.075757576,40,115,1.875,26,62,1.384615385,66,177,2.681818182,4,0,0
POA3759,92,176,1.913043478,118,505,2.279661017,74,260,2.513513514,192,765,3.984375,19,48,1.526315789,18,44,1.444444444,37,92,2.486486486,0,0,#DIV/0!
POA3760,31,62,2,41,160,1.902439024,28,83,1.964285714,69,243,3.52173913,11,19,0.727272727,0,6,#DIV/0!,11,25,2.272727273,0,0,#DIV/0!
POA3761,94,189,2.010638298,108,463,2.287037037,64,232,2.625,172,695,4.040697674,26,78,2,16,33,1.0625,42,111,2.642857143,4,3,0.75
POA3763,102,199,1.950980392,134,547,2.082089552,47,161,2.425531915,181,708,3.91160221,34,92,1.705882353,19,45,1.368421053,53,137,2.58490566,0,3,#DIV/0!
POA3764,715,1415,1.979020979,675,2808,2.16,276,963,2.489130435,951,3771,3.965299685,170,506,1.976470588,144,323,1.243055556,314,829,2.640127389,17,42,2.470588235
POA3765,613,1211,1.975530179,597,2487,2.165829146,348,1245,2.577586207,945,3732,3.949206349,106,310,1.924528302,124,299,1.411290323,230,609,2.647826087,21,41,1.952380952
POA3766,128,252,1.96875,108,422,1.907407407,54,186,2.444444444,162,608,3.75308642,23,65,1.826086957,26,50,0.923076923,49,115,2.346938776,3,4,1.333333333
POA3767,149,298,2,103,436,2.233009709,49,158,2.224489796,152,594,3.907894737,15,57,2.8,32,71,1.21875,47,128,2.723404255,4,3,0.75
POA3770,321,636,1.981308411,285,1205,2.228070175,190,650,2.421052632,475,1855,3.905263158,49,147,2,67,148,1.208955224,116,295,2.543103448,7,16,2.285714286
POA3775,364,724,1.989010989,329,1350,2.103343465,161,541,2.360248447,490,1891,3.859183673,64,183,1.859375,57,124,1.175438596,121,307,2.537190083,13,26,2
POA3777,1090,2155,1.97706422,788,3236,2.106598985,417,1399,2.354916067,1205,4635,3.846473029,274,777,1.835766423,214,457,1.135514019,488,1234,2.528688525,25,53,2.12
POA3778,76,156,2.052631579,32,123,1.84375,13,37,1.846153846,45,160,3.555555556,5,19,2.8,4,7,0.75,9,26,2.888888889,0,7,#DIV/0!
POA3779,36,75,2.083333333,12,47,1.916666667,6,12,1,18,59,3.277777778,9,24,1.666666667,0,3,#DIV/0!,9,27,3,3,0,0
POA3781,372,731,1.965053763,422,1755,2.158767773,194,682,2.515463918,616,2437,3.956168831,115,334,1.904347826,76,169,1.223684211,191,503,2.633507853,5,6,1.2
POA3782,815,1615,1.981595092,688,2876,2.180232558,422,1456,2.450236967,1110,4332,3.902702703,127,355,1.795275591,118,274,1.322033898,245,629,2.567346939,11,29,2.636363636
POA3783,214,424,1.981308411,200,847,2.235,96,323,2.364583333,296,1170,3.952702703,34,94,1.764705882,51,118,1.31372549,85,212,2.494117647,3,3,1
POA3785,0,0,#DIV/0!,0,0,#DIV/0!,0,0,#DIV/0!,0,0,#DIV/0!,0,0,#DIV/0!,0,0,#DIV/0!,0,0,#DIV/0!,0,0,#DIV/0!
POA3786,155,308,1.987096774,146,604,2.136986301,78,266,2.41025641,224,870,3.883928571,24,56,1.333333333,23,64,1.782608696,47,120,2.553191489,0,3,#DIV/0!
POA3787,116,232,2,104,416,2,67,220,2.28358209,171,636,3.719298246,17,39,1.294117647,28,61,1.178571429,45,100,2.222222222,0,4,#DIV/0!
POA3788,200,395,1.975,139,563,2.050359712,76,247,2.25,215,810,3.76744186,33,74,1.242424242,29,64,1.206896552,62,138,2.225806452,7,14,2
POA3789,35,77,2.2,18,76,2.222222222,16,47,1.9375,34,123,3.617647059,6,11,0.833333333,5,14,1.8,11,25,2.272727273,0,0,#DIV/0!
POA3791,182,357,1.961538462,132,537,2.068181818,77,266,2.454545455,209,803,3.842105263,20,53,1.65,40,81,1.025,60,134,2.233333333,0,0,#DIV/0!
POA3792,104,203,1.951923077,92,386,2.195652174,65,214,2.292307692,157,600,3.821656051,15,45,2,21,43,1.047619048,36,88,2.444444444,3,3,1
POA3793,366,726,1.983606557,276,1142,2.137681159,164,555,2.384146341,440,1697,3.856818182,82,223,1.719512195,88,202,1.295454545,170,425,2.5,12,22,1.833333333
POA3795,137,277,2.02189781,115,505,2.391304348,53,183,2.452830189,168,688,4.095238095,17,48,1.823529412,22,45,1.045454545,39,93,2.384615385,3,4,1.333333333
POA3796,812,1643,2.023399015,936,3934,2.202991453,450,1559,2.464444444,1386,5493,3.963203463,181,512,1.828729282,186,432,1.322580645,367,944,2.572207084,26,50,1.923076923
POA3797,319,634,1.987460815,237,1002,2.227848101,133,450,2.383458647,370,1452,3.924324324,75,203,1.706666667,53,119,1.245283019,128,322,2.515625,9,16,1.777777778
POA3799,604,1180,1.953642384,411,1689,2.109489051,192,624,2.25,603,2313,3.835820896,225,637,1.831111111,156,344,1.205128205,381,981,2.57480315,15,28,1.866666667
POA3800,3,5,1.666666667,5,19,1.8,0,0,#DIV/0!,5,19,3.8,0,0,#DIV/0!,0,0,#DIV/0!,0,0,#DIV/0!,3,0,0
POA3802,1943,3910,2.012352033,2137,8940,2.183434722,1693,6005,2.546958063,3830,14945,3.902088773,465,1478,2.178494624,612,1474,1.408496732,1077,2952,2.740947075,90,195,2.166666667
POA3803,839,1691,2.015494636,874,3691,2.223112128,529,1874,2.542533081,1403,5565,3.966500356,252,758,2.007936508,261,613,1.348659004,513,1371,2.67251462,35,72,2.057142857
POA3804,543,1093,2.012891344,637,2838,2.455259027,487,1749,2.59137577,1124,4587,4.080960854,60,183,2.05,61,143,1.344262295,121,326,2.694214876,10,20,2
POA3805,3695,7448,2.015696888,6136,25943,2.227998696,2462,8803,2.575548335,8598,34746,4.041172366,1230,3846,2.126829268,972,2313,1.37962963,2202,6159,2.797002725,150,322,2.146666667
POA3806,3717,7442,2.002152273,5007,20581,2.110445376,1881,6636,2.527910686,6888,27217,3.951364692,904,2652,1.933628319,747,1749,1.341365462,1651,4401,2.665657177,117,261,2.230769231
POA3807,449,888,1.977728285,778,3267,2.199228792,347,1265,2.645533141,1125,4532,4.028444444,94,287,2.053191489,97,222,1.288659794,191,509,2.664921466,18,37,2.055555556
POA3808,272,529,1.944852941,310,1317,2.248387097,169,597,2.532544379,479,1914,3.995824635,24,71,1.958333333,30,71,1.366666667,54,142,2.62962963,3,10,3.333333333
POA3809,187,381,2.037433155,165,712,2.315151515,68,239,2.514705882,233,951,4.081545064,32,81,1.53125,24,50,1.083333333,56,131,2.339285714,12,23,1.916666667
POA3810,3265,6542,2.003675345,3582,14681,2.098548297,952,3274,2.43907563,4534,17955,3.9600794,1053,3151,1.992402659,638,1468,1.300940439,1691,4619,2.731519811,138,283,2.050724638
POA3812,230,449,1.952173913,197,869,2.411167513,137,473,2.452554745,334,1342,4.017964072,41,125,2.048780488,30,66,1.2,71,191,2.690140845,6,18,3
POA3813,103,205,1.990291262,99,470,2.747474747,53,187,2.528301887,152,657,4.322368421,8,36,3.5,19,37,0.947368421,27,73,2.703703704,3,3,1
POA3814,190,379,1.994736842,175,782,2.468571429,83,278,2.34939759,258,1060,4.108527132,34,99,1.911764706,29,65,1.24137931,63,164,2.603174603,0,4,#DIV/0!
POA3815,292,580,1.98630137,259,1174,2.532818533,138,451,2.268115942,397,1625,4.093198992,41,102,1.487804878,37,83,1.243243243,78,185,2.371794872,6,15,2.5
POA3816,209,420,2.009569378,158,674,2.265822785,71,239,2.366197183,229,913,3.986899563,53,154,1.905660377,50,101,1.02,103,255,2.475728155,14,25,1.785714286
POA3818,1365,2720,1.992673993,959,4075,2.249217935,428,1469,2.432242991,1387,5544,3.997116078,280,833,1.975,224,495,1.209821429,504,1328,2.634920635,32,66,2.0625
POA3820,1552,3076,1.981958763,1119,4719,2.217158177,469,1583,2.375266525,1588,6302,3.968513854,374,1101,1.943850267,273,594,1.175824176,647,1695,2.619783617,53,108,2.037735849
POA3821,299,581,1.943143813,211,925,2.383886256,139,478,2.438848921,350,1403,4.008571429,34,102,2,45,90,1,79,192,2.430379747,6,19,3.166666667
POA3822,113,226,2,107,461,2.308411215,37,132,2.567567568,144,593,4.118055556,9,25,1.777777778,16,33,1.0625,25,58,2.32,5,6,1.2
POA3823,235,457,1.944680851,127,565,2.448818898,71,228,2.211267606,198,793,4.005050505,31,100,2.225806452,28,66,1.357142857,59,166,2.813559322,6,12,2
POA3824,528,1036,1.962121212,375,1561,2.162666667,161,541,2.360248447,536,2102,3.921641791,100,280,1.8,75,153,1.04,175,433,2.474285714,17,37,2.176470588
POA3825,2163,4273,1.975496995,1329,5537,2.166290444,696,2328,2.344827586,2025,7865,3.883950617,662,1945,1.938066465,465,991,1.131182796,1127,2936,2.605146406,84,178,2.119047619
POA3831,185,356,1.924324324,116,489,2.215517241,53,167,2.150943396,169,656,3.881656805,32,96,2,20,47,1.35,52,143,2.75,5,15,3
POA3832,54,110,2.037037037,23,114,2.956521739,25,77,2.08,48,191,3.979166667,9,21,1.333333333,9,13,0.444444444,18,34,1.888888889,0,4,#DIV/0!
POA3833,47,87,1.85106383,13,56,2.307692308,9,25,1.777777778,22,81,3.681818182,8,25,2.125,0,8,#DIV/0!,8,33,4.125,0,0,#DIV/0!
POA3835,62,125,2.016129032,43,183,2.255813953,24,73,2.041666667,67,256,3.820895522,9,24,1.666666667,9,23,1.555555556,18,47,2.611111111,4,6,1.5
POA3840,1765,3494,1.979603399,1015,4231,2.168472906,561,1849,2.295900178,1576,6080,3.85786802,571,1731,2.031523643,392,861,1.196428571,963,2592,2.691588785,80,156,1.95
POA3842,504,988,1.96031746,327,1299,1.972477064,163,531,2.257668712,490,1830,3.734693878,172,534,2.104651163,108,227,1.101851852,280,761,2.717857143,13,25,1.923076923
POA3844,2909,5720,1.966311447,2271,9187,2.045354469,912,3003,2.292763158,3183,12190,3.82972039,748,2156,1.882352941,459,984,1.14379085,1207,3140,2.601491301,81,166,2.049382716
POA3847,283,557,1.96819788,145,619,2.268965517,97,316,2.257731959,242,935,3.863636364,55,165,2,42,101,1.404761905,97,266,2.742268041,6,8,1.333333333
POA3850,1467,2870,1.956373551,1124,4554,2.051601423,411,1311,2.189781022,1535,5865,3.820846906,416,1230,1.956730769,257,566,1.20233463,673,1796,2.668647845,52,101,1.942307692
POA3851,586,1150,1.962457338,290,1222,2.213793103,135,430,2.185185185,425,1652,3.887058824,75,217,1.893333333,53,118,1.226415094,128,335,2.6171875,5,15,3
POA3852,4,8,2,7,25,1.571428571,0,3,#DIV/0!,7,28,4,0,3,#DIV/0!,0,5,#DIV/0!,0,8,#DIV/0!,3,3,1
POA3854,156,314,2.012820513,140,583,2.164285714,78,244,2.128205128,218,827,3.793577982,22,59,1.681818182,20,45,1.25,42,104,2.476190476,3,3,1
POA3856,116,224,1.931034483,76,320,2.210526316,37,133,2.594594595,113,453,4.008849558,20,59,1.95,17,34,1,37,93,2.513513514,3,0,0
POA3857,42,78,1.857142857,34,139,2.088235294,11,40,2.636363636,45,179,3.977777778,8,24,2,3,3,0,11,27,2.454545455,0,0,#DIV/0!
POA3858,325,631,1.941538462,227,960,2.22907489,93,307,2.301075269,320,1267,3.959375,79,228,1.886075949,58,117,1.017241379,137,345,2.518248175,6,12,2
POA3859,108,200,1.851851852,76,344,2.526315789,35,121,2.457142857,111,465,4.189189189,15,47,2.133333333,10,22,1.2,25,69,2.76,0,4,#DIV/0!
POA3860,844,1647,1.951421801,532,2255,2.238721805,223,719,2.224215247,755,2974,3.939072848,158,474,2,108,231,1.138888889,266,705,2.65037594,19,31,1.631578947
POA3862,392,765,1.951530612,267,1093,2.093632959,108,344,2.185185185,375,1437,3.832,54,158,1.925925926,44,84,0.909090909,98,242,2.469387755,5,7,1.4
POA3864,52,101,1.942307692,31,127,2.096774194,15,41,1.733333333,46,168,3.652173913,8,28,2.5,0,5,#DIV/0!,8,33,4.125,0,4,#DIV/0!
POA3865,65,119,1.830769231,31,124,2,12,38,2.166666667,43,162,3.76744186,8,25,2.125,4,13,2.25,12,38,3.166666667,0,3,#DIV/0!
POA3869,174,336,1.931034483,130,538,2.138461538,64,217,2.390625,194,755,3.891752577,33,93,1.818181818,14,36,1.571428571,47,129,2.744680851,8,11,1.375
POA3870,191,370,1.937172775,124,504,2.064516129,61,202,2.31147541,185,706,3.816216216,25,75,2,31,72,1.322580645,56,147,2.625,5,9,1.8
POA3871,356,700,1.966292135,231,959,2.151515152,104,337,2.240384615,335,1296,3.868656716,48,154,2.208333333,41,90,1.195121951,89,244,2.741573034,3,11,3.666666667
POA3873,64,127,1.984375,38,156,2.105263158,18,57,2.166666667,56,213,3.803571429,4,9,1.25,8,21,1.625,12,30,2.5,0,3,#DIV/0!
POA3874,80,154,1.925,27,119,2.407407407,15,48,2.2,42,167,3.976190476,12,34,1.833333333,12,23,0.916666667,24,57,2.375,0,0,#DIV/0!
POA3875,2073,4075,1.965750121,1210,5023,2.151239669,487,1569,2.221765914,1697,6592,3.884502062,460,1361,1.958695652,308,663,1.152597403,768,2024,2.635416667,45,99,2.2
POA3878,138,265,1.920289855,41,172,2.195121951,16,51,2.1875,57,223,3.912280702,10,38,2.8,14,25,0.785714286,24,63,2.625,3,0,0
POA3880,664,1302,1.960843373,188,747,1.973404255,86,269,2.127906977,274,1016,3.708029197,67,177,1.641791045,45,98,1.177777778,112,275,2.455357143,3,10,3.333333333
POA3882,167,327,1.958083832,61,248,2.06557377,34,105,2.088235294,95,353,3.715789474,14,43,2.071428571,16,34,1.125,30,77,2.566666667,3,6,2
POA3885,243,474,1.950617284,141,576,2.085106383,66,218,2.303030303,207,794,3.835748792,36,94,1.611111111,29,58,1,65,152,2.338461538,3,4,1.333333333
POA3886,56,108,1.928571429,41,176,2.292682927,17,49,1.882352941,58,225,3.879310345,8,26,2.25,4,3,-0.25,12,29,2.416666667,0,0,#DIV/0!
POA3887,46,91,1.97826087,29,125,2.310344828,7,19,1.714285714,36,144,4,7,8,0.142857143,4,13,2.25,11,21,1.909090909,0,0,#DIV/0!
POA3888,480,925,1.927083333,263,1118,2.25095057,90,290,2.222222222,353,1408,3.988668555,96,284,1.958333333,66,152,1.303030303,162,436,2.691358025,5,15,3
POA3889,40,76,1.9,10,46,2.6,5,14,1.8,15,60,4,9,28,2.111111111,6,13,1.166666667,15,41,2.733333333,0,0,#DIV/0!
POA3890,26,50,1.923076923,0,10,#DIV/0!,5,6,0.2,5,16,3.2,7,27,2.857142857,7,13,0.857142857,14,40,2.857142857,0,0,#DIV/0!
POA3891,38,74,1.947368421,4,22,3.5,8,17,1.125,12,39,3.25,3,8,1.666666667,3,0,-1,6,8,1.333333333,0,0,#DIV/0!
POA3892,164,311,1.896341463,62,237,1.822580645,23,64,1.782608696,85,301,3.541176471,22,59,1.681818182,21,44,1.095238095,43,103,2.395348837,0,0,#DIV/0!
POA3895,28,49,1.75,7,40,3.714285714,6,11,0.833333333,13,51,3.923076923,3,0,-1,3,7,1.333333333,6,7,1.166666667,0,0,#DIV/0!
POA3896,55,111,2.018181818,33,123,1.727272727,13,38,1.923076923,46,161,3.5,10,26,1.6,6,13,1.166666667,16,39,2.4375,0,0,#DIV/0!
POA3898,77,146,1.896103896,30,116,1.866666667,14,38,1.714285714,44,154,3.5,13,38,1.923076923,12,26,1.166666667,25,64,2.56,3,7,2.333333333
POA3900,33,66,2,14,64,2.571428571,3,8,1.666666667,17,72,4.235294118,5,10,1,6,9,0.5,11,19,1.727272727,0,0,#DIV/0!
POA3902,68,139,2.044117647,17,78,2.588235294,10,24,1.4,27,102,3.777777778,11,23,1.090909091,3,7,1.333333333,14,30,2.142857143,0,0,#DIV/0!
POA3903,115,228,1.982608696,38,158,2.157894737,13,43,2.307692308,51,201,3.941176471,12,30,1.5,8,14,0.75,20,44,2.2,3,4,1.333333333
POA3904,247,479,1.939271255,64,262,2.09375,23,79,2.434782609,87,341,3.91954023,16,46,1.875,15,28,0.866666667,31,74,2.387096774,4,5,1.25
POA3909,1061,2089,1.968897267,472,1937,2.103813559,213,694,2.258215962,685,2631,3.840875912,193,590,2.056994819,129,280,1.170542636,322,870,2.701863354,28,50,1.785714286
POA3910,1906,3799,1.993179433,1983,8130,2.099848714,1067,3713,2.479850047,3050,11843,3.88295082,547,1539,1.813528336,477,1080,1.264150943,1024,2619,2.557617188,54,120,2.222222222
POA3911,321,637,1.984423676,258,1048,2.062015504,183,628,2.431693989,441,1676,3.800453515,84,247,1.94047619,85,198,1.329411765,169,445,2.633136095,10,20,2
POA3912,1350,2718,2.013333333,1314,5453,2.149923896,721,2464,2.417475728,2035,7917,3.89041769,345,1009,1.924637681,287,665,1.317073171,632,1674,2.648734177,44,91,2.068181818
POA3913,352,695,1.974431818,283,1172,2.141342756,156,553,2.544871795,439,1725,3.929384966,96,258,1.6875,61,146,1.393442623,157,404,2.573248408,8,21,2.625
POA3915,904,1821,2.014380531,626,2574,2.111821086,268,905,2.376865672,894,3479,3.891498881,351,1043,1.971509972,234,521,1.226495726,585,1564,2.673504274,40,80,2
POA3916,75,147,1.96,36,145,2.027777778,28,90,2.214285714,64,235,3.671875,6,23,2.833333333,12,19,0.583333333,18,42,2.333333333,3,3,1
POA3918,362,717,1.980662983,337,1385,2.109792285,128,434,2.390625,465,1819,3.911827957,66,182,1.757575758,54,127,1.351851852,120,309,2.575,8,16,2
POA3919,278,560,2.014388489,229,942,2.113537118,109,350,2.211009174,338,1292,3.822485207,83,238,1.86746988,71,162,1.281690141,154,400,2.597402597,13,26,2
POA3920,33,58,1.757575758,45,181,2.022222222,0,0,#DIV/0!,45,181,4.022222222,10,16,0.6,0,3,#DIV/0!,10,19,1.9,0,0,#DIV/0!
POA3921,19,33,1.736842105,6,24,2,0,4,#DIV/0!,6,28,4.666666667,0,4,#DIV/0!,3,0,-1,3,4,1.333333333,0,0,#DIV/0!
POA3922,876,1733,1.978310502,440,1775,2.034090909,155,491,2.167741935,595,2266,3.808403361,157,412,1.624203822,117,249,1.128205128,274,661,2.412408759,18,27,1.5
POA3923,111,220,1.981981982,38,156,2.105263158,21,62,1.952380952,59,218,3.694915254,14,32,1.285714286,7,17,1.428571429,21,49,2.333333333,0,3,#DIV/0!
POA3925,395,769,1.946835443,225,897,1.986666667,62,185,1.983870968,287,1082,3.770034843,62,159,1.564516129,55,108,0.963636364,117,267,2.282051282,4,13,3.25
POA3926,388,765,1.971649485,250,1038,2.152,144,482,2.347222222,394,1520,3.85786802,51,147,1.882352941,58,122,1.103448276,109,269,2.467889908,7,8,1.142857143
POA3927,184,355,1.929347826,116,484,2.172413793,45,137,2.044444444,161,621,3.857142857,16,43,1.6875,21,47,1.238095238,37,90,2.432432432,3,7,2.333333333
POA3928,61,122,2,38,164,2.315789474,20,67,2.35,58,231,3.982758621,5,13,1.6,6,12,1,11,25,2.272727273,0,0,#DIV/0!
POA3929,129,251,1.945736434,45,192,2.266666667,27,79,1.925925926,72,271,3.763888889,14,29,1.071428571,8,22,1.75,22,51,2.318181818,0,0,#DIV/0!
POA3930,1829,3593,1.964461454,1614,6687,2.143122677,845,2881,2.409467456,2459,9568,3.891012607,202,576,1.851485149,274,577,1.105839416,476,1153,2.422268908,28,62,2.214285714
POA3931,2592,5137,1.981867284,1665,6664,2.002402402,689,2282,2.312046444,2354,8946,3.800339847,584,1627,1.785958904,508,1148,1.25984252,1092,2775,2.541208791,58,113,1.948275862
POA3933,118,232,1.966101695,77,339,2.402597403,75,250,2.333333333,152,589,3.875,16,34,1.125,11,28,1.545454545,27,62,2.296296296,0,0,#DIV/0!
POA3934,1809,3572,1.974571587,1672,6860,2.102870813,623,2136,2.428571429,2295,8996,3.919825708,269,763,1.836431227,244,543,1.225409836,513,1306,2.545808967,29,61,2.103448276
POA3936,1291,2536,1.964368706,550,2226,2.047272727,265,880,2.320754717,815,3106,3.811042945,218,598,1.743119266,195,421,1.158974359,413,1019,2.467312349,28,60,2.142857143
POA3937,244,489,2.004098361,163,680,2.171779141,65,205,2.153846154,228,885,3.881578947,24,54,1.25,27,57,1.111111111,51,111,2.176470588,3,9,3
POA3938,410,800,1.951219512,137,551,2.02189781,91,298,2.274725275,228,849,3.723684211,37,109,1.945945946,48,108,1.25,85,217,2.552941176,4,13,3.25
POA3939,1766,3497,1.9801812,799,3304,2.135168961,400,1351,2.3775,1199,4655,3.882402002,362,1034,1.856353591,336,738,1.196428571,698,1772,2.538681948,39,75,1.923076923
POA3940,610,1210,1.983606557,190,753,1.963157895,80,266,2.325,270,1019,3.774074074,120,350,1.916666667,90,202,1.244444444,210,552,2.628571429,10,28,2.8
POA3941,1417,2817,1.988002823,755,3078,2.076821192,348,1117,2.209770115,1103,4195,3.803263826,292,827,1.832191781,231,508,1.199134199,523,1335,2.552581262,24,54,2.25
POA3942,316,619,1.958860759,126,505,2.007936508,49,163,2.326530612,175,668,3.817142857,30,82,1.733333333,37,73,0.972972973,67,155,2.313432836,7,10,1.428571429
POA3943,254,483,1.901574803,49,197,2.020408163,37,121,2.27027027,86,318,3.697674419,13,40,2.076923077,15,26,0.733333333,28,66,2.357142857,3,12,4
POA3944,80,159,1.9875,10,39,1.9,13,34,1.615384615,23,73,3.173913043,3,6,1,0,3,#DIV/0!,3,9,3,0,0,#DIV/0!
POA3945,146,288,1.97260274,62,256,2.129032258,47,155,2.29787234,109,411,3.770642202,16,51,2.1875,17,39,1.294117647,33,90,2.727272727,0,0,#DIV/0!
POA3950,552,1096,1.985507246,329,1437,2.367781155,140,445,2.178571429,469,1882,4.012793177,129,390,2.023255814,79,176,1.227848101,208,566,2.721153846,13,29,2.230769231
POA3951,124,244,1.967741935,81,352,2.345679012,35,123,2.514285714,116,475,4.094827586,10,26,1.6,11,21,0.909090909,21,47,2.238095238,4,9,2.25
POA3953,917,1806,1.969465649,568,2392,2.211267606,191,616,2.22513089,759,3008,3.963109354,168,474,1.821428571,120,247,1.058333333,288,721,2.503472222,14,35,2.5
POA3954,44,90,2.045454545,37,159,2.297297297,11,34,2.090909091,48,193,4.020833333,6,16,1.666666667,3,10,2.333333333,9,26,2.888888889,0,0,#DIV/0!
POA3956,328,648,1.975609756,150,618,2.12,62,206,2.322580645,212,824,3.886792453,38,110,1.894736842,24,53,1.208333333,62,163,2.629032258,0,0,#DIV/0!
POA3957,59,122,2.06779661,36,164,2.555555556,17,55,2.235294118,53,219,4.132075472,5,10,1,5,9,0.8,10,19,1.9,0,0,#DIV/0!
POA3958,74,145,1.959459459,45,183,2.066666667,17,64,2.764705882,62,247,3.983870968,7,19,1.714285714,7,13,0.857142857,14,32,2.285714286,0,0,#DIV/0!
POA3959,137,265,1.934306569,73,297,2.068493151,36,119,2.305555556,109,416,3.816513761,15,44,1.933333333,11,21,0.909090909,26,65,2.5,0,3,#DIV/0!
POA3960,326,640,1.963190184,151,605,2.006622517,65,208,2.2,216,813,3.763888889,40,105,1.625,28,61,1.178571429,68,166,2.441176471,4,11,2.75
POA3962,166,333,2.006024096,64,262,2.09375,42,124,1.952380952,106,386,3.641509434,28,86,2.071428571,23,46,1,51,132,2.588235294,0,7,#DIV/0!
POA3965,35,63,1.8,7,16,0.285714286,3,10,2.333333333,10,26,2.6,0,6,#DIV/0!,0,3,#DIV/0!,0,9,#DIV/0!,0,0,#DIV/0!
POA3966,101,198,1.96039604,41,173,2.219512195,21,61,1.904761905,62,234,3.774193548,20,57,1.85,11,22,1,31,79,2.548387097,3,5,1.666666667
POA3971,589,1155,1.960950764,236,991,2.199152542,116,369,2.181034483,352,1360,3.863636364,85,267,2.141176471,66,141,1.136363636,151,408,2.701986755,15,37,2.466666667
POA3975,912,1844,2.021929825,1539,6163,2.004548408,416,1502,2.610576923,1955,7665,3.920716113,212,640,2.018867925,120,284,1.366666667,332,924,2.78313253,38,81,2.131578947
POA3976,1458,2964,2.032921811,2511,10696,2.259657507,1027,3662,2.565725414,3538,14358,4.058224986,643,1968,2.060653188,556,1309,1.354316547,1199,3277,2.733110926,117,256,2.188034188
POA3977,5717,11535,2.017666608,6768,27983,2.134604019,2387,8299,2.476749057,9155,36282,3.963080284,1846,5622,2.045503792,1436,3359,1.33913649,3282,8981,2.736441194,265,569,2.147169811
POA3978,128,253,1.9765625,110,472,2.290909091,65,225,2.461538462,175,697,3.982857143,18,56,2.111111111,21,43,1.047619048,39,99,2.538461538,3,13,4.333333333
POA3979,92,184,2,59,239,2.050847458,24,82,2.416666667,83,321,3.86746988,12,43,2.583333333,7,8,0.142857143,19,51,2.684210526,4,4,1
POA3980,326,645,1.978527607,289,1184,2.096885813,127,433,2.409448819,416,1617,3.887019231,62,193,2.112903226,71,160,1.253521127,133,353,2.654135338,4,8,2
POA3981,408,812,1.990196078,379,1602,2.226912929,181,623,2.44198895,560,2225,3.973214286,94,300,2.191489362,78,173,1.217948718,172,473,2.75,15,31,2.066666667
POA3984,625,1251,2.0016,295,1241,2.206779661,145,471,2.248275862,440,1712,3.890909091,135,401,1.97037037,80,164,1.05,215,565,2.627906977,13,24,1.846153846
POA3987,164,326,1.987804878,125,512,2.096,50,167,2.34,175,679,3.88,26,81,2.115384615,14,37,1.642857143,40,118,2.95,0,0,#DIV/0!
POA3988,107,213,1.990654206,82,361,2.402439024,31,97,2.129032258,113,458,4.053097345,16,45,1.8125,14,29,1.071428571,30,74,2.466666667,3,3,1
POA3991,59,116,1.966101695,37,148,2,13,44,2.384615385,50,192,3.84,3,12,3,9,14,0.555555556,12,26,2.166666667,3,0,0
POA3992,61,125,2.049180328,52,193,1.711538462,17,62,2.647058824,69,255,3.695652174,14,32,1.285714286,14,33,1.357142857,28,65,2.321428571,3,6,2
POA3995,1047,2068,1.975167144,605,2541,2.2,283,938,2.314487633,888,3479,3.917792793,221,645,1.918552036,195,438,1.246153846,416,1083,2.603365385,29,67,2.310344828
POA3996,730,1438,1.969863014,338,1367,2.044378698,111,335,2.018018018,449,1702,3.79064588,71,183,1.577464789,61,126,1.06557377,132,309,2.340909091,11,22,2
POA4000,1694,3301,1.948642267,390,1350,1.461538462,179,563,2.145251397,569,1913,3.362038664,78,185,1.371794872,144,315,1.1875,222,500,2.252252252,160,334,2.0875
POA4005,1446,2828,1.955739972,446,1664,1.730941704,162,548,2.382716049,608,2212,3.638157895,89,211,1.370786517,123,268,1.178861789,212,479,2.259433962,108,219,2.027777778
POA4006,2013,3918,1.946348733,423,1484,1.508274232,179,570,2.184357542,602,2054,3.411960133,116,273,1.353448276,151,322,1.132450331,267,595,2.228464419,124,247,1.991935484
POA4007,1123,2202,1.960819234,692,2789,2.030346821,315,1093,2.46984127,1007,3882,3.855014896,144,370,1.569444444,206,445,1.160194175,350,815,2.328571429,73,147,2.01369863
POA4008,30,61,2.033333333,15,67,2.466666667,10,27,1.7,25,94,3.76,8,26,2.25,13,23,0.769230769,21,49,2.333333333,3,3,1
POA4009,0,0,#DIV/0!,0,0,#DIV/0!,0,0,#DIV/0!,0,0,#DIV/0!,0,0,#DIV/0!,0,0,#DIV/0!,0,0,#DIV/0!,0,0,#DIV/0!
POA4010,221,429,1.941176471,95,361,1.8,34,105,2.088235294,129,466,3.612403101,19,56,1.947368421,32,68,1.125,51,124,2.431372549,24,53,2.208333333
POA4011,1430,2798,1.956643357,1071,4276,1.992530345,420,1467,2.492857143,1491,5743,3.851777331,213,532,1.497652582,308,685,1.224025974,521,1217,2.335892514,109,232,2.128440367
POA4012,2127,4212,1.980253879,1512,5869,1.881613757,504,1717,2.406746032,2016,7586,3.762896825,386,1019,1.639896373,430,931,1.165116279,816,1950,2.389705882,168,338,2.011904762
POA4013,422,842,1.995260664,336,1299,1.866071429,129,436,2.379844961,465,1735,3.731182796,82,220,1.682926829,76,163,1.144736842,158,383,2.424050633,37,83,2.243243243
POA4014,1065,2113,1.984037559,915,3622,1.958469945,364,1244,2.417582418,1279,4866,3.804534793,228,645,1.828947368,245,540,1.204081633,473,1185,2.505285412,59,126,2.13559322
POA4017,3602,7136,1.981121599,3071,12367,2.027027027,1372,4628,2.373177843,4443,16995,3.825118163,822,2364,1.875912409,860,1926,1.239534884,1682,4290,2.550535077,167,357,2.137724551
POA4018,998,1974,1.977955912,706,2706,1.83286119,258,879,2.406976744,964,3585,3.718879668,226,612,1.707964602,202,447,1.212871287,428,1059,2.474299065,51,106,2.078431373
POA4019,2126,4227,1.988240828,1214,4877,2.017298188,536,1704,2.179104478,1750,6581,3.760571429,611,1701,1.78396072,498,1059,1.126506024,1109,2760,2.488728584,99,195,1.96969697
POA4020,2528,5002,1.978639241,1293,5186,2.010827533,679,2254,2.319587629,1972,7440,3.772819473,494,1349,1.730769231,501,1088,1.171656687,995,2437,2.449246231,90,191,2.122222222
POA4021,1036,2070,1.998069498,682,2825,2.142228739,356,1208,2.393258427,1038,4033,3.885356455,334,998,1.988023952,229,515,1.248908297,563,1513,2.687388988,50,108,2.16
POA4022,649,1282,1.975346687,522,2176,2.168582375,227,758,2.339207048,749,2934,3.917222964,210,684,2.257142857,148,336,1.27027027,358,1020,2.849162011,30,64,2.133333333
POA4025,13,28,2.153846154,0,11,#DIV/0!,3,3,0,3,14,4.666666667,0,0,#DIV/0!,3,3,0,3,3,1,0,0,#DIV/0!
POA4030,1476,2915,1.974932249,1203,4691,1.899418121,318,1092,2.433962264,1521,5783,3.802103879,219,563,1.570776256,249,545,1.18875502,468,1108,2.367521368,147,311,2.115646259
POA4031,1183,2359,1.99408284,1069,4224,1.951356408,314,1093,2.48089172,1383,5317,3.844540853,235,626,1.663829787,236,517,1.190677966,471,1143,2.426751592,93,193,2.075268817
POA4032,1576,3138,1.991116751,937,3777,2.03094984,391,1294,2.309462916,1328,5071,3.818524096,319,886,1.777429467,365,819,1.243835616,684,1705,2.492690058,130,276,2.123076923
POA4034,4549,9081,1.996262915,3071,12367,2.027027027,1643,5563,2.385879489,4714,17930,3.803563852,924,2726,1.95021645,980,2245,1.290816327,1904,4971,2.610819328,225,485,2.155555556
POA4035,2121,4238,1.998114097,2353,9805,2.167020824,1324,4631,2.497734139,3677,14436,3.926026652,343,991,1.889212828,391,911,1.329923274,734,1902,2.591280654,65,140,2.153846154
POA4036,759,1507,1.985507246,638,2597,2.070532915,263,879,2.342205323,901,3476,3.857935627,173,469,1.710982659,148,339,1.290540541,321,808,2.517133956,47,97,2.063829787
POA4037,592,1170,1.976351351,1035,4212,2.069565217,366,1278,2.491803279,1401,5490,3.91862955,132,370,1.803030303,88,211,1.397727273,220,581,2.640909091,12,23,1.916666667
POA4051,2357,4640,1.968604158,2261,8919,1.944714728,619,2115,2.416801292,2880,11034,3.83125,416,1067,1.564903846,421,954,1.266033254,837,2021,2.414575866,229,474,2.069868996
POA4053,4355,8657,1.98783008,3612,14340,1.970099668,1494,5048,2.378848728,5106,19388,3.797101449,911,2546,1.794731065,960,2142,1.23125,1871,4688,2.505611972,258,539,2.089147287
POA4054,1374,2740,1.994177584,1134,4571,2.030864198,439,1471,2.350797267,1573,6042,3.841068023,362,1079,1.980662983,336,743,1.211309524,698,1822,2.610315186,68,143,2.102941176
POA4055,1837,3642,1.982580294,2151,8739,2.062761506,920,3145,2.418478261,3071,11884,3.869749267,333,921,1.765765766,293,654,1.232081911,626,1575,2.515974441,53,113,2.132075472
POA4059,1069,2098,1.962581852,749,2848,1.802403204,206,678,2.291262136,955,3526,3.692146597,151,373,1.470198675,127,277,1.181102362,278,650,2.338129496,160,335,2.09375
POA4060,1026,2010,1.959064327,1265,5201,2.111462451,462,1608,2.480519481,1727,6809,3.942675159,178,476,1.674157303,228,525,1.302631579,406,1001,2.465517241,69,153,2.217391304
POA4061,1567,3100,1.978302489,1539,6295,2.090318389,803,2804,2.491905355,2342,9099,3.885140905,247,695,1.813765182,347,809,1.331412104,594,1504,2.531986532,49,88,1.795918367
POA4064,1114,2175,1.952423698,646,2488,1.851393189,181,629,2.475138122,827,3117,3.76904474,119,294,1.470588235,151,341,1.258278146,270,635,2.351851852,86,182,2.11627907
POA4065,816,1596,1.955882353,918,3714,2.045751634,329,1124,2.416413374,1247,4838,3.879711307,127,344,1.708661417,150,319,1.126666667,277,663,2.393501805,63,128,2.031746032
POA4066,1677,3309,1.973166369,883,3415,1.867497169,305,1024,2.357377049,1188,4439,3.736531987,118,308,1.610169492,219,465,1.123287671,337,773,2.293768546,296,613,2.070945946
POA4067,851,1656,1.945945946,410,1597,1.895121951,192,632,2.291666667,602,2229,3.702657807,68,173,1.544117647,91,210,1.307692308,159,383,2.408805031,147,311,2.115646259
POA4068,2240,4418,1.972321429,1400,5533,1.952142857,645,2206,2.420155039,2045,7739,3.784352078,216,565,1.615740741,370,829,1.240540541,586,1394,2.37883959,260,551,2.119230769
POA4069,3123,6144,1.967339097,3203,13190,2.118014362,1853,6322,2.411764706,5056,19512,3.859177215,387,1082,1.795865633,525,1218,1.32,912,2300,2.521929825,115,241,2.095652174
POA4070,1022,2012,1.968688845,1210,4973,2.109917355,460,1549,2.367391304,1670,6522,3.905389222,182,540,1.967032967,150,353,1.353333333,332,893,2.689759036,27,62,2.296296296
POA4072,3,6,2,3,14,2.666666667,0,7,#DIV/0!,3,21,7,0,0,#DIV/0!,0,0,#DIV/0!,0,0,#DIV/0!,0,0,#DIV/0!
POA4073,871,1735,1.991963261,1029,4112,1.996112731,422,1430,2.388625592,1451,5542,3.819434873,137,380,1.773722628,113,279,1.469026549,250,659,2.636,29,61,2.103448276
POA4074,2269,4523,1.993389158,2158,8695,2.029193698,1279,4329,2.384675528,3437,13024,3.789351178,403,1132,1.808933002,445,1020,1.292134831,848,2152,2.537735849,84,177,2.107142857
POA4075,1910,3799,1.989005236,1965,7963,2.052417303,756,2581,2.414021164,2721,10544,3.875045939,328,893,1.722560976,387,873,1.255813953,715,1766,2.46993007,118,258,2.186440678
POA4076,351,707,2.014245014,356,1500,2.213483146,149,522,2.503355705,505,2022,4.003960396,109,334,2.064220183,138,346,1.507246377,247,680,2.753036437,43,98,2.279069767
POA4077,1779,3606,2.02698145,1960,8761,2.469897959,774,2745,2.546511628,2734,11506,4.208485735,968,3091,2.193181818,742,1746,1.35309973,1710,4837,2.828654971,152,326,2.144736842
POA4078,1948,3906,2.00513347,2474,9968,2.029102668,843,2921,2.465005931,3317,12889,3.885740127,627,1832,1.92185008,424,971,1.29009434,1051,2803,2.666983825,87,183,2.103448276
POA4101,1999,3911,1.956478239,887,3365,1.793686584,416,1415,2.401442308,1303,4780,3.668457406,265,669,1.524528302,315,715,1.26984127,580,1384,2.386206897,192,406,2.114583333
POA4102,563,1122,1.992895204,334,1302,1.898203593,111,382,2.441441441,445,1684,3.784269663,90,214,1.377777778,108,248,1.296296296,198,462,2.333333333,74,155,2.094594595
POA4103,1299,2578,1.984603541,882,3359,1.808390023,289,993,2.435986159,1171,4352,3.71648164,204,542,1.656862745,227,513,1.259911894,431,1055,2.447795824,154,309,2.006493506
POA4104,578,1148,1.98615917,411,1656,2.02919708,162,546,2.37037037,573,2202,3.842931937,85,223,1.623529412,89,192,1.157303371,174,415,2.385057471,61,127,2.081967213
POA4105,1294,2573,1.988408037,1008,3961,1.929563492,349,1188,2.404011461,1357,5149,3.79439941,242,641,1.648760331,246,543,1.207317073,488,1184,2.426229508,99,210,2.121212121
POA4106,114,226,1.98245614,71,278,1.915492958,28,85,2.035714286,99,363,3.666666667,26,64,1.461538462,26,56,1.153846154,52,120,2.307692308,15,33,2.2
POA4107,528,1052,1.992424242,486,1935,1.981481481,153,517,2.379084967,639,2452,3.837245696,121,355,1.933884298,170,377,1.217647059,291,732,2.515463918,37,82,2.216216216
POA4108,432,876,2.027777778,311,1255,2.035369775,154,526,2.415584416,465,1781,3.830107527,116,351,2.025862069,126,301,1.388888889,242,652,2.694214876,38,82,2.157894737
POA4109,3411,6888,2.019349164,2427,9864,2.064276885,1619,5521,2.41012971,4046,15385,3.802521008,563,1680,1.98401421,833,1975,1.370948379,1396,3655,2.618194842,288,619,2.149305556
POA4110,841,1696,2.016646849,728,3101,2.259615385,348,1216,2.494252874,1076,4317,4.012081784,292,937,2.20890411,248,584,1.35483871,540,1521,2.816666667,56,119,2.125
POA4111,102,192,1.882352941,63,243,1.857142857,24,73,2.041666667,87,316,3.632183908,13,32,1.461538462,17,41,1.411764706,30,73,2.433333333,9,21,2.333333333
POA4112,636,1278,2.009433962,788,3410,2.327411168,347,1238,2.567723343,1135,4648,4.095154185,126,378,2,117,283,1.418803419,243,661,2.720164609,30,64,2.133333333
POA4113,2540,5138,2.022834646,2351,9372,1.986388771,1228,4233,2.447068404,3579,13605,3.801341157,512,1440,1.8125,557,1331,1.389587074,1069,2771,2.592142189,193,423,2.191709845
POA4114,2163,4405,2.036523347,2370,10806,2.559493671,848,2926,2.450471698,3218,13732,4.267246737,1524,4948,2.24671916,929,2117,1.278794403,2453,7065,2.880146759,210,462,2.2
POA4115,1584,3169,2.000631313,1761,7217,2.098239637,824,2854,2.463592233,2585,10071,3.895938104,339,1011,1.982300885,285,680,1.385964912,624,1691,2.709935897,65,141,2.169230769
POA4116,2010,4070,2.024875622,2369,9693,2.091599831,1143,3946,2.45231846,3512,13639,3.883542141,406,1245,2.066502463,382,940,1.460732984,788,2185,2.77284264,120,275,2.291666667
POA4117,111,216,1.945945946,112,469,2.1875,39,128,2.282051282,151,597,3.953642384,22,66,2,14,37,1.642857143,36,103,2.861111111,5,12,2.4
POA4118,2404,4811,2.00124792,2809,11877,2.228195087,1155,3960,2.428571429,3964,15837,3.995206862,870,2640,2.034482759,631,1446,1.291600634,1501,4086,2.72218521,117,243,2.076923077
POA4119,501,1005,2.005988024,568,2325,2.093309859,180,605,2.361111111,748,2930,3.917112299,101,284,1.811881188,109,251,1.302752294,210,535,2.547619048,25,57,2.28
POA4120,971,1930,1.987641607,541,2072,1.829944547,137,453,2.306569343,678,2525,3.724188791,125,311,1.488,127,290,1.283464567,252,601,2.384920635,108,217,2.009259259
POA4121,2328,4621,1.984965636,2172,8753,2.029926335,791,2738,2.461441214,2963,11491,3.878164023,484,1348,1.785123967,520,1150,1.211538462,1004,2498,2.488047809,172,358,2.081395349
POA4122,4152,8318,2.003371869,3368,13766,2.087292162,1610,5463,2.393167702,4978,19229,3.862796304,820,2431,1.964634146,984,2239,1.275406504,1804,4670,2.588691796,277,581,2.097472924
POA4123,1702,3389,1.991186839,1379,5660,2.104423495,698,2371,2.396848138,2077,8031,3.866634569,374,1103,1.949197861,345,772,1.237681159,719,1875,2.607788595,73,152,2.082191781
POA4124,1537,3104,2.019518543,1963,8241,2.198166072,711,2399,2.374120956,2674,10640,3.979057592,502,1522,2.03187251,261,585,1.24137931,763,2107,2.76146789,55,115,2.090909091
POA4125,820,1642,2.002439024,541,2349,2.341959335,376,1293,2.438829787,917,3642,3.971646674,121,354,1.925619835,90,198,1.2,211,552,2.616113744,14,23,1.642857143
POA4127,2117,4227,1.996693434,1709,7050,2.125219427,920,3068,2.334782609,2629,10118,3.848611639,641,1859,1.900156006,575,1321,1.297391304,1216,3180,2.615131579,106,217,2.047169811
POA4128,1540,3097,2.011038961,1518,6212,2.092226614,836,2837,2.39354067,2354,9049,3.844095157,330,944,1.860606061,307,727,1.368078176,637,1671,2.623233909,53,104,1.962264151
POA4129,561,1113,1.983957219,618,2523,2.082524272,218,708,2.247706422,836,3231,3.864832536,183,540,1.950819672,132,299,1.265151515,315,839,2.663492063,37,76,2.054054054
POA4130,857,1701,1.984830805,707,2945,2.165487977,455,1579,2.47032967,1162,4524,3.893287435,143,396,1.769230769,116,279,1.405172414,259,675,2.606177606,20,38,1.9
POA4131,712,1436,2.016853933,752,3213,2.272606383,306,1022,2.339869281,1058,4235,4.002835539,358,1120,2.12849162,230,515,1.239130435,588,1635,2.780612245,65,148,2.276923077
POA4132,1417,2856,2.015525759,2112,9397,2.449337121,688,2360,2.430232558,2800,11757,4.198928571,977,3122,2.195496418,505,1161,1.299009901,1482,4283,2.890013495,84,183,2.178571429
POA4133,1365,2729,1.999267399,1200,5110,2.258333333,528,1786,2.382575758,1728,6896,3.990740741,447,1372,2.06935123,290,692,1.386206897,737,2064,2.800542741,51,101,1.980392157
POA4151,1584,3151,1.989267677,1110,4346,1.915315315,379,1304,2.440633245,1489,5650,3.794492948,222,542,1.441441441,230,499,1.169565217,452,1041,2.303097345,151,314,2.079470199
POA4152,4154,8285,1.994463168,3726,15055,2.040526033,1776,6192,2.486486486,5502,21247,3.861686659,769,2128,1.767230169,907,2097,1.312017641,1676,4225,2.520883055,241,514,2.132780083
POA4153,432,881,2.039351852,468,1862,1.978632479,228,789,2.460526316,696,2651,3.808908046,79,239,2.025316456,95,220,1.315789474,174,459,2.637931034,13,32,2.461538462
POA4154,744,1484,1.994623656,1204,4890,2.061461794,308,1032,2.350649351,1512,5922,3.916666667,165,468,1.836363636,121,281,1.32231405,286,749,2.618881119,27,64,2.37037037
POA4155,104,207,1.990384615,113,499,2.415929204,53,187,2.528301887,166,686,4.13253012,10,33,2.3,10,31,2.1,20,64,3.2,3,8,2.666666667
POA4156,282,553,1.960992908,337,1423,2.222551929,171,591,2.456140351,508,2014,3.964566929,20,53,1.65,29,70,1.413793103,49,123,2.510204082,5,6,1.2
POA4157,1845,3692,2.001084011,1613,6669,2.134531928,907,3089,2.405733186,2520,9758,3.872222222,409,1176,1.875305623,405,898,1.217283951,814,2074,2.547911548,67,134,2
POA4158,412,818,1.985436893,254,992,1.905511811,108,369,2.416666667,362,1361,3.759668508,124,332,1.677419355,94,191,1.031914894,218,523,2.399082569,21,42,2
POA4159,1405,2809,1.999288256,1204,4955,2.115448505,655,2274,2.471755725,1859,7229,3.888649812,278,847,2.04676259,250,575,1.3,528,1422,2.693181818,48,102,2.125
POA4160,1712,3392,1.981308411,1578,6425,2.071609632,959,3261,2.400417101,2537,9686,3.817895152,350,991,1.831428571,287,667,1.324041812,637,1658,2.602825746,39,83,2.128205128
POA4161,1633,3252,1.991426822,1465,5983,2.083959044,752,2591,2.445478723,2217,8574,3.867388363,437,1292,1.956521739,418,965,1.30861244,855,2257,2.639766082,76,153,2.013157895
POA4163,1840,3673,1.996195652,929,3709,1.992465016,623,2071,2.32423756,1552,5780,3.724226804,305,851,1.790163934,348,789,1.267241379,653,1640,2.511485452,54,111,2.055555556
POA4164,1229,2461,2.002441009,1290,5380,2.170542636,646,2188,2.386996904,1936,7568,3.909090909,226,672,1.973451327,188,428,1.276595745,414,1100,2.657004831,28,56,2
POA4165,3647,7260,1.990677269,3298,13472,2.084899939,1298,4320,2.328197227,4596,17792,3.871192341,686,2050,1.988338192,509,1187,1.332023576,1195,3237,2.708786611,66,142,2.151515152
POA4169,1538,2999,1.94993498,472,1762,1.733050847,204,654,2.205882353,676,2416,3.573964497,112,267,1.383928571,178,393,1.207865169,290,660,2.275862069,109,229,2.100917431
POA4170,2335,4601,1.970449679,1826,7100,1.888280394,520,1799,2.459615385,2346,8899,3.793265132,391,1019,1.606138107,407,914,1.245700246,798,1933,2.422305764,173,357,2.063583815
POA4171,1484,2903,1.956199461,1364,5329,1.906891496,405,1421,2.508641975,1769,6750,3.815715093,223,557,1.497757848,223,498,1.233183857,446,1055,2.365470852,65,131,2.015384615
POA4172,388,767,1.976804124,344,1321,1.840116279,138,464,2.362318841,482,1785,3.703319502,115,329,1.860869565,111,245,1.207207207,226,574,2.539823009,29,63,2.172413793
POA4173,858,1720,2.004662005,778,3084,1.964010283,300,1016,2.386666667,1078,4100,3.803339518,216,601,1.782407407,214,476,1.224299065,430,1077,2.504651163,42,91,2.166666667
POA4174,260,524,2.015384615,225,890,1.955555556,87,296,2.402298851,312,1186,3.801282051,89,254,1.853932584,63,135,1.142857143,152,389,2.559210526,16,37,2.3125
POA4178,2344,4687,1.999573379,1951,7852,2.024602768,778,2600,2.341902314,2729,10452,3.82997435,634,1800,1.839116719,580,1309,1.256896552,1214,3109,2.560955519,129,262,2.031007752
POA4179,1902,3764,1.978969506,1666,6644,1.987995198,648,2201,2.396604938,2314,8845,3.82238548,413,1135,1.748184019,382,851,1.227748691,795,1986,2.498113208,79,162,2.050632911
POA4183,256,495,1.93359375,112,444,1.964285714,46,143,2.108695652,158,587,3.715189873,69,227,2.289855072,39,83,1.128205128,108,310,2.87037037,7,16,2.285714286
POA4184,926,1806,1.950323974,256,1069,2.17578125,99,320,2.232323232,355,1389,3.912676056,243,713,1.934156379,126,273,1.166666667,369,986,2.672086721,21,43,2.047619048
POA4205,506,1009,1.994071146,318,1330,2.182389937,123,416,2.382113821,441,1746,3.959183673,149,441,1.959731544,96,221,1.302083333,245,662,2.702040816,18,43,2.388888889
POA4207,4539,9090,2.002643754,3754,15547,2.141449121,1761,5949,2.378194208,5515,21496,3.897733454,1564,4639,1.966112532,1022,2271,1.222113503,2586,6910,2.672080433,200,419,2.095
POA4208,1550,3102,2.001290323,1829,7564,2.13559322,458,1507,2.290393013,2287,9071,3.966331439,372,1138,2.059139785,171,404,1.362573099,543,1542,2.839779006,38,71,1.868421053
POA4209,2821,5616,1.99078341,3965,16147,2.072383354,837,2853,2.408602151,4802,19000,3.956684715,1063,3230,2.038570085,466,1060,1.274678112,1529,4290,2.805755396,82,162,1.975609756
POA4210,1572,3119,1.984096692,1682,6840,2.066587396,616,2074,2.366883117,2298,8914,3.879025239,409,1164,1.84596577,292,670,1.294520548,701,1834,2.616262482,54,109,2.018518519
POA4211,5396,10783,1.998332098,5175,20783,2.016038647,2020,6753,2.343069307,7195,27536,3.827102154,1534,4342,1.830508475,1151,2591,1.251086012,2685,6933,2.582122905,172,353,2.052325581
POA4212,3121,6160,1.97372637,2040,8170,2.004901961,1037,3431,2.308582449,3077,11601,3.770230744,473,1349,1.852008457,422,953,1.258293839,895,2302,2.572067039,66,139,2.106060606
POA4213,2608,5180,1.986196319,2701,11038,2.08663458,1211,4085,2.373245252,3912,15123,3.865797546,651,1931,1.966205837,518,1187,1.291505792,1169,3118,2.667236955,67,142,2.119402985
POA4214,3336,6692,2.005995204,3020,12095,2.004966887,1434,4819,2.360529986,4454,16914,3.797485406,895,2503,1.796648045,813,1849,1.274292743,1708,4352,2.548009368,188,392,2.085106383
POA4215,4819,9567,1.985266653,2183,8284,1.794777829,766,2469,2.223237598,2949,10753,3.646320787,1225,3271,1.670204082,1222,2663,1.179214403,2447,5934,2.425010217,320,648,2.025
POA4216,4886,9629,1.970732706,2090,8108,1.879425837,990,3189,2.221212121,3080,11297,3.667857143,791,2110,1.667509482,770,1633,1.120779221,1561,3743,2.397821909,130,268,2.061538462
POA4217,4457,8771,1.967915638,1725,6731,1.902028986,882,2873,2.257369615,2607,9604,3.683927886,554,1425,1.572202166,653,1390,1.12863706,1207,2815,2.332228666,198,406,2.050505051
POA4218,3586,7075,1.972950363,1696,6578,1.878537736,774,2574,2.325581395,2470,9152,3.705263158,529,1377,1.603024575,638,1369,1.145768025,1167,2746,2.353041988,157,318,2.025477707
POA4219,90,182,2.022222222,20,68,1.4,5,16,2.2,25,84,3.36,19,49,1.578947368,12,29,1.416666667,31,78,2.516129032,3,7,2.333333333
POA4220,3366,6651,1.975935829,1967,7674,1.901372649,837,2742,2.275985663,2804,10416,3.714693295,664,1760,1.65060241,683,1504,1.20204978,1347,3264,2.423162584,135,274,2.02962963
POA4221,2716,5381,1.981222386,1904,7600,1.991596639,870,2877,2.306896552,2774,10477,3.776856525,700,1986,1.837142857,660,1438,1.178787879,1360,3424,2.517647059,118,248,2.101694915
POA4223,1551,3040,1.96002579,1096,4424,2.03649635,512,1681,2.283203125,1608,6105,3.796641791,356,999,1.806179775,323,715,1.213622291,679,1714,2.524300442,67,140,2.089552239
POA4224,562,1102,1.960854093,363,1411,1.887052342,151,486,2.218543046,514,1897,3.690661479,143,396,1.769230769,150,320,1.133333333,293,716,2.443686007,32,64,2
POA4225,892,1753,1.965246637,222,803,1.617117117,87,278,2.195402299,309,1081,3.498381877,145,380,1.620689655,159,334,1.100628931,304,714,2.348684211,33,66,2
POA4226,3150,6266,1.989206349,2248,8872,1.946619217,1173,3883,2.310315431,3421,12755,3.728441976,712,2017,1.832865169,629,1444,1.295707472,1341,3461,2.580909769,103,214,2.077669903
POA4227,1608,3204,1.992537313,1702,6788,1.988249119,548,1826,2.332116788,2250,8614,3.828444444,643,1848,1.874027994,460,1032,1.243478261,1103,2880,2.611060743,83,178,2.144578313
POA4228,486,966,1.987654321,470,1988,2.229787234,275,930,2.381818182,745,2918,3.916778523,71,209,1.943661972,57,125,1.192982456,128,334,2.609375,11,17,1.545454545
POA4229,129,247,1.914728682,54,174,1.222222222,13,55,3.230769231,67,229,3.417910448,33,72,1.181818182,29,62,1.137931034,62,134,2.161290323,17,44,2.588235294
POA4230,246,486,1.975609756,85,287,1.376470588,46,138,2,131,425,3.244274809,37,102,1.756756757,43,92,1.139534884,80,194,2.425,8,23,2.875
POA4270,395,789,1.997468354,344,1421,2.130813953,145,486,2.351724138,489,1907,3.899795501,60,182,2.033333333,44,89,1.022727273,104,271,2.605769231,8,16,2
POA4271,392,768,1.959183673,211,820,1.886255924,71,214,2.014084507,282,1034,3.666666667,81,214,1.641975309,54,116,1.148148148,135,330,2.444444444,5,6,1.2
POA4272,665,1307,1.965413534,319,1350,2.231974922,133,402,2.022556391,452,1752,3.876106195,85,254,1.988235294,69,152,1.202898551,154,406,2.636363636,11,18,1.636363636
POA4275,316,627,1.984177215,290,1219,2.203448276,115,381,2.313043478,405,1600,3.950617284,50,145,1.9,41,89,1.170731707,91,234,2.571428571,3,5,1.666666667
POA4280,1370,2729,1.991970803,1624,6885,2.23953202,590,1971,2.340677966,2214,8856,4,354,1046,1.95480226,189,438,1.317460317,543,1484,2.732965009,26,54,2.076923077
POA4285,1910,3792,1.985340314,1698,7246,2.26737338,591,1961,2.318104907,2289,9207,4.022280472,482,1465,2.039419087,285,638,1.238596491,767,2103,2.741851369,55,112,2.036363636
POA4287,69,142,2.057971014,38,170,2.473684211,16,45,1.8125,54,215,3.981481481,16,43,1.6875,15,29,0.933333333,31,72,2.322580645,4,9,2.25
POA4300,3626,7227,1.99310535,4635,19319,2.16806904,1366,4657,2.409224012,6001,23976,3.995334111,1524,4737,2.108267717,771,1772,1.298313878,2295,6509,2.836165577,179,384,2.145251397
POA4301,1702,3391,1.992361927,2225,9535,2.285393258,673,2314,2.43833581,2898,11849,4.08868185,973,3007,2.090441932,429,999,1.328671329,1402,4006,2.857346648,100,213,2.13
POA4303,318,643,2.022012579,216,1023,2.736111111,100,332,2.32,316,1355,4.287974684,217,750,2.456221198,107,238,1.224299065,324,988,3.049382716,31,68,2.193548387
POA4304,1504,3021,2.008643617,1108,4658,2.203971119,479,1575,2.288100209,1587,6233,3.927536232,512,1563,2.052734375,387,887,1.291989664,899,2450,2.725250278,95,204,2.147368421
POA4305,5214,10370,1.988876103,4514,18601,2.12073549,1817,6157,2.388552559,6331,24758,3.910598642,2030,6154,2.031527094,1271,2830,1.226593234,3301,8984,2.721599515,272,572,2.102941176
POA4306,3198,6341,1.982801751,3057,12776,2.179260713,1357,4502,2.31761238,4414,17278,3.914363389,567,1747,2.081128748,415,915,1.204819277,982,2662,2.710794297,68,137,2.014705882
POA4307,127,250,1.968503937,105,458,2.361904762,41,146,2.56097561,146,604,4.136986301,24,66,1.75,17,39,1.294117647,41,105,2.56097561,3,11,3.666666667
POA4309,301,599,1.990033223,207,907,2.381642512,85,279,2.282352941,292,1186,4.061643836,40,107,1.675,31,71,1.290322581,71,178,2.507042254,9,17,1.888888889
POA4310,860,1695,1.970930233,439,1842,2.195899772,197,649,2.294416244,636,2491,3.916666667,123,366,1.975609756,79,184,1.329113924,202,550,2.722772277,16,32,2
POA4311,1022,2024,1.980430528,747,3175,2.250334672,312,1015,2.253205128,1059,4190,3.956562795,293,917,2.129692833,152,334,1.197368421,445,1251,2.811235955,29,61,2.103448276
POA4312,455,886,1.947252747,196,826,2.214285714,78,248,2.179487179,274,1074,3.919708029,66,193,1.924242424,46,92,1,112,285,2.544642857,9,25,2.777777778
POA4313,256,506,1.9765625,110,473,2.3,48,155,2.229166667,158,628,3.974683544,45,146,2.244444444,32,67,1.09375,77,213,2.766233766,8,6,0.75
POA4340,650,1285,1.976923077,422,1797,2.258293839,236,772,2.271186441,658,2569,3.904255319,154,468,2.038961039,88,197,1.238636364,242,665,2.747933884,16,33,2.0625
POA4341,1463,2912,1.990430622,1054,4529,2.296963947,369,1187,2.216802168,1423,5716,4.016865777,439,1372,2.125284738,211,457,1.165876777,650,1829,2.813846154,45,89,1.977777778
POA4342,265,521,1.966037736,145,626,2.317241379,60,194,2.233333333,205,820,4,56,164,1.928571429,40,90,1.25,96,254,2.645833333,5,13,2.6
POA4343,1098,2189,1.993624772,790,3431,2.343037975,273,903,2.307692308,1063,4334,4.077140169,263,811,2.08365019,159,352,1.213836478,422,1163,2.755924171,41,86,2.097560976
POA4344,288,569,1.975694444,189,844,2.465608466,73,263,2.602739726,262,1107,4.22519084,56,190,2.392857143,39,81,1.076923077,95,271,2.852631579,10,20,2
POA4345,0,0,#DIV/0!,0,4,#DIV/0!,0,0,#DIV/0!,0,4,#DIV/0!,0,0,#DIV/0!,0,0,#DIV/0!,0,0,#DIV/0!,0,0,#DIV/0!
POA4346,60,116,1.933333333,50,201,2.02,19,67,2.526315789,69,268,3.884057971,18,49,1.722222222,3,7,1.333333333,21,56,2.666666667,3,7,2.333333333
POA4347,146,278,1.904109589,91,381,2.186813187,20,67,2.35,111,448,4.036036036,17,57,2.352941176,11,26,1.363636364,28,83,2.964285714,6,10,1.666666667
POA4350,10662,20990,1.968673795,7783,32275,2.146858538,2831,9125,2.22324267,10614,41400,3.900508762,2845,8417,1.958523726,1829,4065,1.22252597,4674,12482,2.670517758,462,955,2.067099567
POA4352,2792,5471,1.959527221,2591,11025,2.255113856,946,3059,2.233615222,3537,14084,3.98190557,386,1161,2.007772021,247,553,1.238866397,633,1714,2.707740916,41,91,2.219512195
POA4353,50,107,2.14,25,98,1.92,16,48,2,41,146,3.56097561,3,3,0,3,7,1.333333333,6,10,1.666666667,3,6,2
POA4354,114,219,1.921052632,82,357,2.353658537,37,122,2.297297297,119,479,4.025210084,25,77,2.08,13,31,1.384615385,38,108,2.842105263,6,9,1.5
POA4355,413,807,1.953995157,173,722,2.173410405,67,225,2.358208955,240,947,3.945833333,70,198,1.828571429,39,77,0.974358974,109,275,2.52293578,7,25,3.571428571
POA4356,577,1128,1.954939341,435,1891,2.347126437,150,483,2.22,585,2374,4.058119658,124,362,1.919354839,60,123,1.05,184,485,2.635869565,20,36,1.8
POA4357,319,623,1.952978056,188,793,2.218085106,62,193,2.112903226,250,986,3.944,44,138,2.136363636,38,81,1.131578947,82,219,2.670731707,4,9,2.25
POA4358,239,474,1.983263598,192,804,2.1875,77,239,2.103896104,269,1043,3.87732342,32,86,1.6875,20,38,0.9,52,124,2.384615385,3,8,2.666666667
POA4359,153,298,1.947712418,89,387,2.348314607,35,111,2.171428571,124,498,4.016129032,24,76,2.166666667,28,56,1,52,132,2.538461538,3,7,2.333333333
POA4360,62,114,1.838709677,40,169,2.225,15,50,2.333333333,55,219,3.981818182,18,47,1.611111111,5,13,1.6,23,60,2.608695652,0,0,#DIV/0!
POA4361,303,604,1.99339934,167,705,2.221556886,58,193,2.327586207,225,898,3.991111111,49,156,2.183673469,38,84,1.210526316,87,240,2.75862069,9,15,1.666666667
POA4362,362,704,1.944751381,201,874,2.348258706,88,262,1.977272727,289,1136,3.930795848,68,191,1.808823529,32,68,1.125,100,259,2.59,11,24,2.181818182
POA4363,63,116,1.841269841,49,182,1.714285714,16,60,2.75,65,242,3.723076923,12,43,2.583333333,5,10,1,17,53,3.117647059,3,4,1.333333333
POA4364,30,63,2.1,37,149,2.027027027,8,21,1.625,45,170,3.777777778,0,8,#DIV/0!,3,7,1.333333333,3,15,5,0,0,#DIV/0!
POA4365,57,113,1.98245614,27,109,2.037037037,9,32,2.555555556,36,141,3.916666667,7,19,1.714285714,7,10,0.428571429,14,29,2.071428571,0,9,#DIV/0!
POA4370,1981,3924,1.980817769,1366,5742,2.203513909,465,1480,2.182795699,1831,7222,3.944292736,510,1571,2.080392157,302,666,1.205298013,812,2237,2.754926108,55,117,2.127272727
POA4371,98,201,2.051020408,57,264,2.631578947,20,59,1.95,77,323,4.194805195,16,53,2.3125,11,19,0.727272727,27,72,2.666666667,4,4,1
POA4372,29,54,1.862068966,17,76,2.470588235,11,31,1.818181818,28,107,3.821428571,3,7,1.333333333,0,3,#DIV/0!,3,10,3.333333333,0,0,#DIV/0!
POA4373,164,319,1.945121951,77,338,2.38961039,29,97,2.344827586,106,435,4.103773585,28,97,2.464285714,16,34,1.125,44,131,2.977272727,6,13,2.166666667
POA4374,56,108,1.928571429,25,104,2.16,12,34,1.833333333,37,138,3.72972973,0,3,#DIV/0!,7,16,1.285714286,7,19,2.714285714,0,0,#DIV/0!
POA4375,18,37,2.055555556,15,53,1.533333333,3,20,5.666666667,18,73,4.055555556,0,6,#DIV/0!,6,9,0.5,6,15,2.5,0,0,#DIV/0!
POA4376,41,79,1.926829268,22,97,2.409090909,7,27,2.857142857,29,124,4.275862069,7,19,1.714285714,9,16,0.777777778,16,35,2.1875,0,3,#DIV/0!
POA4377,66,135,2.045454545,37,137,1.702702703,16,56,2.5,53,193,3.641509434,4,21,4.25,6,10,0.666666667,10,31,3.1,0,3,#DIV/0!
POA4378,81,160,1.975308642,32,136,2.25,24,70,1.916666667,56,206,3.678571429,10,28,1.8,4,10,1.5,14,38,2.714285714,0,0,#DIV/0!
POA4380,1024,2038,1.990234375,559,2339,2.184257603,176,585,2.323863636,735,2924,3.978231293,177,511,1.88700565,115,251,1.182608696,292,762,2.609589041,29,60,2.068965517
POA4381,60,119,1.983333333,44,170,1.863636364,10,35,2.5,54,205,3.796296296,11,31,1.818181818,6,19,2.166666667,17,50,2.941176471,4,3,0.75
POA4382,68,125,1.838235294,40,180,2.5,20,56,1.8,60,236,3.933333333,4,23,4.75,5,5,0,9,28,3.111111111,3,5,1.666666667
POA4383,84,169,2.011904762,43,193,2.488372093,24,65,1.708333333,67,258,3.850746269,16,53,2.3125,9,20,1.222222222,25,73,2.92,3,8,2.666666667
POA4385,175,344,1.965714286,87,354,2.068965517,17,54,2.176470588,104,408,3.923076923,21,63,2,14,31,1.214285714,35,94,2.685714286,3,7,2.333333333
POA4387,174,346,1.988505747,93,390,2.193548387,34,90,1.647058824,127,480,3.779527559,37,101,1.72972973,21,43,1.047619048,58,144,2.482758621,3,10,3.333333333
POA4388,60,121,2.016666667,48,192,2,5,16,2.2,53,208,3.924528302,9,38,3.222222222,4,10,1.5,13,48,3.692307692,0,0,#DIV/0!
POA4390,653,1302,1.993874426,641,2627,2.098283931,158,486,2.075949367,799,3113,3.89612015,155,462,1.980645161,75,164,1.186666667,230,626,2.72173913,31,63,2.032258065
POA4400,239,454,1.89958159,174,740,2.252873563,54,175,2.240740741,228,915,4.013157895,36,108,2,18,42,1.333333333,54,150,2.777777778,3,3,1
POA4401,606,1200,1.98019802,429,1823,2.249417249,140,449,2.207142857,569,2272,3.992970123,154,483,2.136363636,86,191,1.220930233,240,674,2.808333333,19,33,1.736842105
POA4402,49,96,1.959183673,14,91,4.5,6,9,0.5,20,100,5,3,8,1.666666667,5,6,0.2,8,14,1.75,0,4,#DIV/0!
POA4403,81,159,1.962962963,68,290,2.264705882,32,104,2.25,100,394,3.94,4,9,1.25,6,14,1.333333333,10,23,2.3,0,0,#DIV/0!
POA4404,27,55,2.037037037,32,142,2.4375,14,41,1.928571429,46,183,3.97826087,10,21,1.1,0,3,#DIV/0!,10,24,2.4,0,3,#DIV/0!
POA4405,1350,2661,1.971111111,1243,5288,2.254223652,326,1017,2.119631902,1569,6305,4.01848311,340,1050,2.088235294,174,376,1.16091954,514,1426,2.774319066,42,85,2.023809524
POA4406,174,341,1.959770115,137,587,2.284671533,35,102,1.914285714,172,689,4.005813953,19,67,2.526315789,21,44,1.095238095,40,111,2.775,8,11,1.375
POA4407,81,158,1.950617284,65,275,2.230769231,12,36,2,77,311,4.038961039,13,48,2.692307692,6,8,0.333333333,19,56,2.947368421,0,7,#DIV/0!
POA4408,109,214,1.963302752,66,292,2.424242424,26,77,1.961538462,92,369,4.010869565,19,54,1.842105263,8,17,1.125,27,71,2.62962963,0,3,#DIV/0!
POA4410,157,306,1.949044586,89,364,2.08988764,35,105,2,124,469,3.782258065,30,91,2.033333333,15,28,0.866666667,45,119,2.644444444,6,12,2
POA4411,45,85,1.888888889,26,94,1.615384615,9,24,1.666666667,35,118,3.371428571,3,10,2.333333333,5,12,1.4,8,22,2.75,0,0,#DIV/0!
POA4412,35,69,1.971428571,42,182,2.333333333,12,43,2.583333333,54,225,4.166666667,0,6,#DIV/0!,3,4,0.333333333,3,10,3.333333333,0,4,#DIV/0!
POA4413,721,1410,1.955617198,606,2565,2.232673267,150,452,2.013333333,756,3017,3.990740741,118,357,2.025423729,82,173,1.109756098,200,530,2.65,23,46,2
POA4415,206,408,1.980582524,148,623,2.209459459,37,112,2.027027027,185,735,3.972972973,33,95,1.878787879,20,41,1.05,53,136,2.566037736,9,25,2.777777778
POA4416,63,120,1.904761905,41,171,2.170731707,0,0,#DIV/0!,41,171,4.170731707,5,13,1.6,0,0,#DIV/0!,5,13,2.6,3,0,0
POA4417,87,169,1.942528736,70,284,2.057142857,19,52,1.736842105,89,336,3.775280899,8,22,1.75,9,26,1.888888889,17,48,2.823529412,5,0,0
POA4419,144,274,1.902777778,92,357,1.880434783,27,86,2.185185185,119,443,3.722689076,13,39,2,6,19,2.166666667,19,58,3.052631579,4,5,1.25
POA4420,145,275,1.896551724,92,371,2.032608696,19,62,2.263157895,111,433,3.900900901,14,56,3,15,29,0.933333333,29,85,2.931034483,5,8,1.6
POA4421,230,452,1.965217391,149,618,2.147651007,50,155,2.1,199,773,3.884422111,68,229,2.367647059,37,78,1.108108108,105,307,2.923809524,10,23,2.3
POA4422,90,177,1.966666667,66,267,2.045454545,19,44,1.315789474,85,311,3.658823529,7,14,1,0,0,#DIV/0!,7,14,2,0,4,#DIV/0!
POA4424,22,48,2.181818182,15,78,3.2,7,18,1.571428571,22,96,4.363636364,4,21,4.25,3,0,-1,7,21,3,4,0,0
POA4425,37,80,2.162162162,24,95,1.958333333,3,17,4.666666667,27,112,4.148148148,7,12,0.714285714,0,7,#DIV/0!,7,19,2.714285714,3,3,1
POA4427,18,38,2.111111111,19,94,2.947368421,5,16,2.2,24,110,4.583333333,3,11,2.666666667,3,5,0.666666667,6,16,2.666666667,0,0,#DIV/0!
POA4428,126,253,2.007936508,72,290,2.027777778,22,60,1.727272727,94,350,3.723404255,18,41,1.277777778,15,28,0.866666667,33,69,2.090909091,3,3,1
POA4454,118,227,1.923728814,82,316,1.853658537,18,47,1.611111111,100,363,3.63,16,46,1.875,9,14,0.555555556,25,60,2.4,3,7,2.333333333
POA4455,837,1614,1.928315412,763,3103,2.066841415,197,608,2.086294416,960,3711,3.865625,152,426,1.802631579,114,242,1.122807018,266,668,2.511278195,27,52,1.925925926
POA4462,20,40,2,12,49,2.083333333,0,4,#DIV/0!,12,53,4.416666667,0,4,#DIV/0!,3,0,-1,3,4,1.333333333,0,0,#DIV/0!
POA4465,184,360,1.956521739,148,578,1.905405405,45,131,1.911111111,193,709,3.67357513,34,94,1.764705882,22,44,1,56,138,2.464285714,0,3,#DIV/0!
POA4468,37,71,1.918918919,27,113,2.185185185,3,24,7,30,137,4.566666667,3,5,0.666666667,7,8,0.142857143,10,13,1.3,3,3,1
POA4470,379,729,1.92348285,326,1312,2.024539877,86,262,2.046511628,412,1574,3.82038835,83,255,2.072289157,54,122,1.259259259,137,377,2.751824818,10,22,2.2
POA4472,212,409,1.929245283,130,513,1.946153846,47,147,2.127659574,177,660,3.728813559,31,85,1.741935484,19,43,1.263157895,50,128,2.56,3,0,0
POA4477,72,132,1.833333333,48,178,1.708333333,21,65,2.095238095,69,243,3.52173913,7,33,3.714285714,3,6,1,10,39,3.9,3,0,0
POA4478,73,132,1.808219178,52,198,1.807692308,11,24,1.181818182,63,222,3.523809524,8,26,2.25,5,9,0.8,13,35,2.692307692,0,6,#DIV/0!
POA4480,106,198,1.867924528,81,307,1.790123457,23,55,1.391304348,104,362,3.480769231,27,71,1.62962963,17,40,1.352941176,44,111,2.522727273,0,3,#DIV/0!
POA4481,49,91,1.857142857,24,89,1.708333333,7,19,1.714285714,31,108,3.483870968,9,15,0.666666667,0,7,#DIV/0!,9,22,2.444444444,0,0,#DIV/0!
POA4486,78,152,1.948717949,61,256,2.196721311,22,52,1.363636364,83,308,3.710843373,12,42,2.5,8,13,0.625,20,55,2.75,0,7,#DIV/0!
POA4487,301,581,1.930232558,303,1277,2.214521452,70,220,2.142857143,373,1497,4.013404826,87,292,2.356321839,35,69,0.971428571,122,361,2.959016393,12,22,1.833333333
POA4488,43,80,1.860465116,29,107,1.689655172,8,19,1.375,37,126,3.405405405,5,9,0.8,7,20,1.857142857,12,29,2.416666667,0,0,#DIV/0!
POA4490,196,385,1.964285714,130,522,2.015384615,39,115,1.948717949,169,637,3.769230769,52,183,2.519230769,28,61,1.178571429,80,244,3.05,6,18,3
POA4492,37,67,1.810810811,34,131,1.852941176,7,17,1.428571429,41,148,3.609756098,3,13,3.333333333,3,3,0,6,16,2.666666667,3,4,1.333333333
POA4494,19,38,2,24,95,1.958333333,0,4,#DIV/0!,24,99,4.125,0,4,#DIV/0!,3,3,0,3,7,2.333333333,0,0,#DIV/0!
POA4496,42,77,1.833333333,35,149,2.257142857,3,11,2.666666667,38,160,4.210526316,4,8,1,3,7,1.333333333,7,15,2.142857143,0,0,#DIV/0!
POA4497,50,99,1.98,36,150,2.166666667,6,13,1.166666667,42,163,3.880952381,7,20,1.857142857,5,10,1,12,30,2.5,0,5,#DIV/0!
POA4498,18,44,2.444444444,26,111,2.269230769,3,11,2.666666667,29,122,4.206896552,3,3,0,0,0,#DIV/0!,3,3,1,4,4,1
POA4500,3527,7038,1.995463567,3771,15559,2.125961283,1565,5326,2.403194888,5336,20885,3.91398051,887,2584,1.91319053,662,1527,1.306646526,1549,4111,2.653970303,147,311,2.115646259
POA4501,516,1025,1.986434109,393,1611,2.099236641,177,587,2.316384181,570,2198,3.856140351,178,505,1.837078652,181,408,1.254143646,359,913,2.543175487,28,56,2
POA4502,837,1664,1.988052569,839,3378,2.026221692,371,1255,2.382749326,1210,4633,3.82892562,213,632,1.96713615,157,366,1.331210191,370,998,2.697297297,29,56,1.931034483
POA4503,3637,7224,1.986252406,3180,12837,2.036792453,1159,3905,2.369283865,4339,16742,3.85849274,1013,2894,1.856860809,633,1422,1.246445498,1646,4316,2.622114216,138,284,2.057971014
POA4504,1296,2590,1.99845679,1954,8171,2.181678608,621,2134,2.436392915,2575,10305,4.001941748,412,1217,1.953883495,174,398,1.287356322,586,1615,2.755972696,40,79,1.975
POA4505,2001,3972,1.985007496,1652,7002,2.238498789,867,2925,2.373702422,2519,9927,3.940849543,387,1124,1.904392765,316,694,1.196202532,703,1818,2.586059744,41,83,2.024390244
POA4506,1722,3439,1.9970964,1741,7269,2.175186674,712,2396,2.365168539,2453,9665,3.94007338,762,2350,2.083989501,385,883,1.293506494,1147,3233,2.818657367,53,113,2.132075472
POA4507,3100,6117,1.973225806,733,2997,2.088676671,435,1422,2.268965517,1168,4419,3.783390411,421,1174,1.788598575,290,632,1.179310345,711,1806,2.540084388,53,107,2.018867925
POA4508,1720,3459,2.011046512,1480,6289,2.249324324,574,1908,2.324041812,2054,8197,3.990749757,880,2671,2.035227273,470,1059,1.253191489,1350,3730,2.762962963,72,149,2.069444444
POA4509,1740,3451,1.983333333,2488,10054,2.040996785,509,1739,2.416502947,2997,11793,3.934934935,466,1358,1.91416309,198,438,1.212121212,664,1796,2.704819277,36,72,2
POA4510,4164,8310,1.995677233,3135,13230,2.220095694,1185,3896,2.287763713,4320,17126,3.964351852,1618,5026,2.106304079,907,2043,1.252480706,2525,7069,2.79960396,170,358,2.105882353
POA4511,1178,2338,1.984719864,595,2500,2.201680672,253,814,2.217391304,848,3314,3.908018868,219,676,2.086757991,103,221,1.145631068,322,897,2.785714286,14,27,1.928571429
POA4512,309,619,2.003236246,278,1186,2.26618705,136,458,2.367647059,414,1644,3.971014493,47,139,1.957446809,38,84,1.210526316,85,223,2.623529412,4,9,2.25
POA4514,647,1291,1.995363215,431,1786,2.143851508,177,568,2.209039548,608,2354,3.871710526,144,416,1.888888889,89,194,1.179775281,233,610,2.618025751,8,25,3.125
POA4515,443,883,1.993227991,252,1056,2.19047619,114,367,2.219298246,366,1423,3.887978142,100,309,2.09,49,104,1.12244898,149,413,2.771812081,14,27,1.928571429
POA4516,380,749,1.971052632,380,1612,2.242105263,176,579,2.289772727,556,2191,3.940647482,61,188,2.081967213,45,91,1.022222222,106,279,2.632075472,4,14,3.5
POA4517,72,148,2.055555556,40,171,2.275,17,50,1.941176471,57,221,3.877192982,14,34,1.428571429,13,25,0.923076923,27,59,2.185185185,0,0,#DIV/0!
POA4518,567,1112,1.961199295,414,1698,2.101449275,181,578,2.193370166,595,2276,3.825210084,109,324,1.972477064,74,160,1.162162162,183,484,2.644808743,12,32,2.666666667
POA4519,898,1776,1.977728285,645,2640,2.093023256,245,782,2.191836735,890,3422,3.84494382,204,605,1.965686275,156,349,1.237179487,360,954,2.65,26,45,1.730769231
POA4520,1261,2484,1.969865186,1370,5772,2.213138686,569,1930,2.391915641,1939,7702,3.972150593,152,422,1.776315789,145,334,1.303448276,297,756,2.545454545,17,31,1.823529412
POA4521,554,1086,1.960288809,441,1842,2.176870748,169,573,2.390532544,610,2415,3.959016393,68,215,2.161764706,53,111,1.094339623,121,326,2.694214876,5,18,3.6
POA4550,471,924,1.961783439,354,1436,2.056497175,164,515,2.140243902,518,1951,3.766409266,114,343,2.00877193,71,159,1.23943662,185,502,2.713513514,6,14,2.333333333
POA4551,6525,12876,1.973333333,3828,15370,2.015151515,1304,4136,2.171779141,5132,19506,3.800857366,1261,3547,1.812846947,888,1948,1.193693694,2149,5495,2.557003257,164,339,2.067073171
POA4552,1259,2464,1.957108817,474,1893,1.993670886,201,634,2.154228856,675,2527,3.743703704,219,588,1.684931507,154,325,1.11038961,373,913,2.44772118,12,30,2.5
POA4553,567,1118,1.971781305,515,2123,2.122330097,206,688,2.339805825,721,2811,3.898751734,116,361,2.112068966,67,145,1.164179104,183,506,2.765027322,22,41,1.863636364
POA4554,207,402,1.942028986,150,610,2.066666667,78,236,2.025641026,228,846,3.710526316,42,122,1.904761905,28,56,1,70,178,2.542857143,5,15,3
POA4555,757,1479,1.953764861,635,2620,2.125984252,243,774,2.185185185,878,3394,3.865603645,161,481,1.98757764,86,186,1.162790698,247,667,2.700404858,12,26,2.166666667
POA4556,4573,8944,1.955827684,3379,13724,2.061556674,1319,4290,2.252463988,4698,18014,3.834397616,806,2291,1.842431762,598,1341,1.242474916,1404,3632,2.586894587,86,191,2.220930233
POA4557,1656,3248,1.961352657,1001,3976,1.972027972,447,1450,2.243847875,1448,5426,3.747237569,394,1060,1.69035533,312,683,1.189102564,706,1743,2.468838527,56,114,2.035714286
POA4558,2364,4636,1.96108291,828,3234,1.905797101,350,1095,2.128571429,1178,4329,3.674872666,451,1181,1.618625277,389,854,1.195372751,840,2035,2.422619048,101,203,2.00990099
POA4559,678,1347,1.986725664,534,2276,2.262172285,212,689,2.25,746,2965,3.974530831,102,278,1.725490196,113,238,1.10619469,215,516,2.4,18,36,2
POA4560,3376,6642,1.967417062,2181,8919,2.089408528,870,2832,2.255172414,3051,11751,3.85152409,760,2226,1.928947368,530,1149,1.167924528,1290,3375,2.61627907,90,184,2.044444444
POA4561,735,1454,1.978231293,584,2388,2.089041096,260,852,2.276923077,844,3240,3.838862559,163,459,1.81595092,100,207,1.07,263,666,2.532319392,23,47,2.043478261
POA4562,951,1851,1.94637224,671,2722,2.056631893,252,790,2.134920635,923,3512,3.804983749,140,384,1.742857143,103,212,1.058252427,243,596,2.452674897,10,23,2.3
POA4563,1090,2156,1.977981651,593,2414,2.070826307,251,790,2.147410359,844,3204,3.796208531,204,604,1.960784314,135,292,1.162962963,339,896,2.643067847,15,31,2.066666667
POA4564,1265,2469,1.951778656,763,2989,1.917431193,271,879,2.243542435,1034,3868,3.740812379,326,893,1.739263804,202,450,1.227722772,528,1343,2.543560606,29,57,1.965517241
POA4565,1804,3558,1.972283814,926,3711,2.007559395,401,1279,2.189526185,1327,4990,3.760361718,382,1104,1.890052356,309,663,1.145631068,691,1767,2.557163531,37,80,2.162162162
POA4566,1172,2292,1.955631399,429,1677,1.909090909,190,595,2.131578947,619,2272,3.670436187,162,405,1.5,122,265,1.172131148,284,670,2.35915493,18,42,2.333333333
POA4567,1372,2646,1.928571429,707,2758,1.900990099,256,803,2.13671875,963,3561,3.697819315,263,700,1.661596958,200,430,1.15,463,1130,2.440604752,29,60,2.068965517
POA4568,451,883,1.957871397,282,1138,2.035460993,110,333,2.027272727,392,1471,3.75255102,98,290,1.959183673,63,131,1.079365079,161,421,2.614906832,6,15,2.5
POA4569,181,356,1.966850829,108,411,1.805555556,44,132,2,152,543,3.572368421,64,192,2,32,64,1,96,256,2.666666667,0,3,#DIV/0!
POA4570,4949,9688,1.957567185,2925,12381,2.232820513,1065,3373,2.16713615,3990,15754,3.948370927,1151,3453,2,641,1391,1.170046802,1792,4844,2.703125,131,265,2.022900763
POA4571,83,157,1.891566265,55,220,2,21,59,1.80952381,76,279,3.671052632,14,40,1.857142857,14,31,1.214285714,28,71,2.535714286,0,3,#DIV/0!
POA4572,448,877,1.957589286,192,763,1.973958333,87,270,2.103448276,279,1033,3.702508961,79,192,1.430379747,62,126,1.032258065,141,318,2.255319149,20,40,2
POA4573,2378,4662,1.960470984,2000,7895,1.9475,527,1685,2.197343454,2527,9580,3.791056589,603,1640,1.71973466,373,790,1.117962466,976,2430,2.489754098,52,104,2
POA4574,157,300,1.910828025,85,346,2.070588235,31,106,2.419354839,116,452,3.896551724,25,78,2.12,17,29,0.705882353,42,107,2.547619048,4,8,2
POA4575,2807,5549,1.976843605,1606,6376,1.97011208,696,2232,2.206896552,2302,8608,3.739357081,513,1405,1.738791423,397,857,1.158690176,910,2262,2.485714286,84,171,2.035714286
POA4580,805,1594,1.980124224,220,902,2.1,72,224,2.111111111,292,1126,3.856164384,132,408,2.090909091,70,150,1.142857143,202,558,2.762376238,15,31,2.066666667
POA4581,204,398,1.950980392,60,246,2.1,17,46,1.705882353,77,292,3.792207792,24,75,2.125,11,22,1,35,97,2.771428571,4,5,1.25
POA4600,143,279,1.951048951,80,326,2.075,15,51,2.4,95,377,3.968421053,15,40,1.666666667,18,41,1.277777778,33,81,2.454545455,4,4,1
POA4601,146,276,1.890410959,78,331,2.243589744,31,96,2.096774194,109,427,3.917431193,27,81,2,13,29,1.230769231,40,110,2.75,3,6,2
POA4605,474,952,2.008438819,362,1705,2.709944751,92,303,2.293478261,454,2008,4.422907489,169,602,2.562130178,62,151,1.435483871,231,753,3.25974026,29,74,2.551724138
POA4606,292,577,1.976027397,151,624,2.132450331,53,172,2.245283019,204,796,3.901960784,60,195,2.25,27,59,1.185185185,87,254,2.91954023,6,16,2.666666667
POA4608,137,270,1.97080292,59,263,2.457627119,27,73,1.703703704,86,336,3.906976744,19,72,2.789473684,17,34,1,36,106,2.944444444,4,3,0.75
POA4610,1681,3287,1.9553837,1203,5059,2.205320033,357,1132,2.170868347,1560,6191,3.968589744,407,1192,1.928746929,235,506,1.153191489,642,1698,2.644859813,56,119,2.125
POA4611,27,60,2.222222222,20,97,2.85,6,14,1.333333333,26,111,4.269230769,6,23,2.833333333,4,3,-0.25,10,26,2.6,0,0,#DIV/0!
POA4612,62,127,2.048387097,32,143,2.46875,15,44,1.933333333,47,187,3.978723404,7,16,1.285714286,3,7,1.333333333,10,23,2.3,5,6,1.2
POA4613,79,150,1.898734177,31,126,2.064516129,10,35,2.5,41,161,3.926829268,6,23,2.833333333,9,14,0.555555556,15,37,2.466666667,0,6,#DIV/0!
POA4614,178,349,1.960674157,68,314,2.617647059,26,87,2.346153846,94,401,4.265957447,36,117,2.25,12,20,0.666666667,48,137,2.854166667,7,15,2.142857143
POA4615,925,1822,1.96972973,449,1952,2.347438753,173,552,2.190751445,622,2504,4.025723473,204,645,2.161764706,116,249,1.146551724,320,894,2.79375,19,39,2.052631579
POA4620,89,175,1.966292135,42,147,1.5,29,95,2.275862069,71,242,3.408450704,6,17,1.833333333,9,20,1.222222222,15,37,2.466666667,3,0,0
POA4621,206,403,1.95631068,83,350,2.21686747,38,117,2.078947368,121,467,3.859504132,27,71,1.62962963,26,49,0.884615385,53,120,2.264150943,4,14,3.5
POA4625,402,797,1.982587065,225,927,2.12,62,196,2.161290323,287,1123,3.912891986,76,237,2.118421053,36,72,1,112,309,2.758928571,11,15,1.363636364
POA4626,276,551,1.996376812,163,639,1.920245399,37,124,2.351351351,200,763,3.815,35,112,2.2,24,51,1.125,59,163,2.762711864,14,18,1.285714286
POA4627,79,147,1.860759494,45,165,1.666666667,11,39,2.545454545,56,204,3.642857143,15,60,3,14,29,1.071428571,29,89,3.068965517,8,15,1.875
POA4630,363,707,1.947658402,208,837,2.024038462,65,195,2,273,1032,3.78021978,58,174,2,28,54,0.928571429,86,228,2.651162791,10,20,2
POA4650,4078,8030,1.969102501,2308,9603,2.160745234,919,2915,2.171926007,3227,12518,3.879144716,977,2902,1.970317298,595,1283,1.156302521,1572,4185,2.66221374,121,243,2.008264463
POA4655,7652,15125,1.976607423,3747,15438,2.120096077,1426,4523,2.171809257,5173,19961,3.858689349,1806,5387,1.982834994,983,2141,1.17802645,2789,7528,2.699175332,137,279,2.03649635
POA4659,794,1553,1.955919395,228,916,2.01754386,83,253,2.048192771,311,1169,3.758842444,98,304,2.102040816,56,116,1.071428571,154,420,2.727272727,7,18,2.571428571
POA4660,1127,2202,1.953859805,390,1656,2.246153846,186,564,2.032258065,576,2220,3.854166667,145,425,1.931034483,95,207,1.178947368,240,632,2.633333333,23,53,2.304347826
POA4662,113,225,1.991150442,56,233,2.160714286,13,41,2.153846154,69,274,3.971014493,38,110,1.894736842,22,48,1.181818182,60,158,2.633333333,0,0,#DIV/0!
POA4670,9763,19204,1.967018335,5531,22983,2.155306455,2165,6922,2.197228637,7696,29905,3.885784823,2251,6849,2.042647712,1466,3232,1.204638472,3717,10081,2.712133441,236,487,2.063559322
POA4671,808,1591,1.969059406,400,1723,2.3075,166,518,2.120481928,566,2241,3.959363958,152,469,2.085526316,107,227,1.121495327,259,696,2.687258687,15,34,2.266666667
POA4673,73,139,1.904109589,34,153,2.5,23,74,2.217391304,57,227,3.98245614,10,26,1.6,3,9,2,13,35,2.692307692,3,4,1.333333333
POA4674,208,403,1.9375,82,326,1.975609756,33,109,2.303030303,115,435,3.782608696,39,112,1.871794872,16,35,1.1875,55,147,2.672727273,8,13,1.625
POA4676,42,89,2.119047619,11,45,2.090909091,8,19,1.375,19,64,3.368421053,7,16,1.285714286,0,5,#DIV/0!,7,21,3,0,0,#DIV/0!
POA4677,384,746,1.942708333,243,939,1.864197531,57,164,1.877192982,300,1103,3.676666667,82,250,2.048780488,38,72,0.894736842,120,322,2.683333333,6,14,2.333333333
POA4678,142,285,2.007042254,57,235,2.122807018,29,83,1.862068966,86,318,3.697674419,19,55,1.894736842,9,20,1.222222222,28,75,2.678571429,3,3,1
POA4680,4867,9596,1.971645778,4910,20055,2.084521385,1674,5423,2.239545998,6584,25478,3.869684083,1003,2898,1.889332004,674,1482,1.198813056,1677,4380,2.611806798,154,315,2.045454545
POA4694,20,37,1.85,21,100,2.761904762,5,24,3.8,26,124,4.769230769,5,19,2.8,0,6,#DIV/0!,5,25,5,3,3,1
POA4695,156,312,2,103,434,2.213592233,40,116,1.9,143,550,3.846153846,28,84,2,21,44,1.095238095,49,128,2.612244898,0,4,#DIV/0!
POA4699,73,142,1.945205479,44,203,2.613636364,11,34,2.090909091,55,237,4.309090909,11,42,2.818181818,8,18,1.25,19,60,3.157894737,0,0,#DIV/0!
POA4700,1568,3048,1.943877551,1204,4914,2.081395349,468,1497,2.198717949,1672,6411,3.834330144,485,1441,1.971134021,438,958,1.187214612,923,2399,2.599133261,92,186,2.02173913
POA4701,4163,8133,1.953639202,3401,13927,2.094972067,1301,4237,2.256725596,4702,18164,3.863037006,1250,3769,2.0152,840,1868,1.223809524,2090,5637,2.697129187,196,409,2.086734694
POA4702,2896,5574,1.924723757,2234,9167,2.10340197,786,2431,2.092875318,3020,11598,3.840397351,502,1462,1.912350598,263,570,1.16730038,765,2032,2.65620915,67,140,2.089552239
POA4703,2539,4914,1.935407641,1598,6499,2.066958698,600,1854,2.09,2198,8353,3.800272975,517,1452,1.808510638,314,696,1.21656051,831,2148,2.584837545,47,94,2
POA4705,35,76,2.171428571,36,155,2.305555556,11,37,2.363636364,47,192,4.085106383,3,4,0.333333333,0,5,#DIV/0!,3,9,3,0,0,#DIV/0!
POA4707,67,129,1.925373134,11,41,1.727272727,5,20,3,16,61,3.8125,3,18,5,7,8,0.142857143,10,26,2.6,0,0,#DIV/0!
POA4709,90,179,1.988888889,206,851,2.131067961,24,79,2.291666667,230,930,4.043478261,4,10,1.5,5,6,0.2,9,16,1.777777778,0,0,#DIV/0!
POA4710,553,1070,1.934900542,256,1019,1.98046875,92,303,2.293478261,348,1322,3.798850575,102,300,1.941176471,55,117,1.127272727,157,417,2.656050955,14,25,1.785714286
POA4711,197,369,1.873096447,189,792,2.19047619,92,316,2.434782609,281,1108,3.943060498,23,60,1.608695652,15,27,0.8,38,87,2.289473684,0,4,#DIV/0!
POA4712,30,57,1.9,16,71,2.4375,7,16,1.285714286,23,87,3.782608696,9,26,1.888888889,0,0,#DIV/0!,9,26,2.888888889,0,0,#DIV/0!
POA4713,21,50,2.380952381,61,330,3.409836066,13,49,2.769230769,74,379,5.121621622,73,306,3.191780822,17,41,1.411764706,90,347,3.855555556,10,25,2.5
POA4714,319,641,2.009404389,138,604,2.376811594,85,252,1.964705882,223,856,3.838565022,116,381,2.284482759,64,130,1.03125,180,511,2.838888889,11,32,2.909090909
POA4715,746,1468,1.967828418,729,2993,2.105624143,193,598,2.098445596,922,3591,3.894793926,145,416,1.868965517,88,178,1.022727273,233,594,2.549356223,20,49,2.45
POA4716,109,210,1.926605505,112,469,2.1875,25,74,1.96,137,543,3.96350365,10,33,2.3,6,9,0.5,16,42,2.625,0,3,#DIV/0!
POA4717,386,758,1.96373057,543,2266,2.173112339,146,485,2.321917808,689,2751,3.992743106,75,229,2.053333333,44,94,1.136363636,119,323,2.714285714,12,30,2.5
POA4718,260,514,1.976923077,258,1107,2.290697674,62,188,2.032258065,320,1295,4.046875,50,150,2,27,59,1.185185185,77,209,2.714285714,5,9,1.8
POA4719,101,195,1.930693069,66,287,2.348484848,24,73,2.041666667,90,360,4,19,56,1.947368421,14,30,1.142857143,33,86,2.606060606,3,4,1.333333333
POA4720,1099,2151,1.957233849,1492,6121,2.102546917,344,1126,2.273255814,1836,7247,3.947167756,208,614,1.951923077,117,264,1.256410256,325,878,2.701538462,44,98,2.227272727
POA4721,378,737,1.94973545,370,1527,2.127027027,88,262,1.977272727,458,1789,3.906113537,48,143,1.979166667,40,84,1.1,88,227,2.579545455,15,33,2.2
POA4722,201,381,1.895522388,160,634,1.9625,33,100,2.03030303,193,734,3.803108808,20,68,2.4,13,25,0.923076923,33,93,2.818181818,8,15,1.875
POA4723,164,310,1.890243902,162,671,2.141975309,55,168,2.054545455,217,839,3.866359447,20,62,2.1,22,46,1.090909091,42,108,2.571428571,0,0,#DIV/0!
POA4724,66,125,1.893939394,54,206,1.814814815,14,40,1.857142857,68,246,3.617647059,4,14,2.5,4,5,0.25,8,19,2.375,0,0,#DIV/0!
POA4725,183,359,1.961748634,143,564,1.944055944,42,137,2.261904762,185,701,3.789189189,33,93,1.818181818,21,43,1.047619048,54,136,2.518518519,3,9,3
POA4726,70,132,1.885714286,56,207,1.696428571,13,44,2.384615385,69,251,3.637681159,16,44,1.75,14,24,0.714285714,30,68,2.266666667,3,3,1
POA4727,42,77,1.833333333,39,162,2.153846154,3,8,1.666666667,42,170,4.047619048,5,24,3.8,6,11,0.833333333,11,35,3.181818182,0,0,#DIV/0!
POA4728,44,79,1.795454545,34,147,2.323529412,13,36,1.769230769,47,183,3.893617021,6,10,0.666666667,0,7,#DIV/0!,6,17,2.833333333,0,0,#DIV/0!
POA4730,353,668,1.892351275,314,1310,2.171974522,68,199,1.926470588,382,1509,3.95026178,97,296,2.051546392,45,99,1.2,142,395,2.781690141,20,39,1.95
POA4731,34,64,1.882352941,16,59,1.6875,11,23,1.090909091,27,82,3.037037037,0,7,#DIV/0!,6,4,-0.333333333,6,11,1.833333333,0,0,#DIV/0!
POA4733,49,97,1.979591837,34,125,1.676470588,15,43,1.866666667,49,168,3.428571429,3,3,0,3,6,1,6,9,1.5,0,3,#DIV/0!
POA4735,109,212,1.944954128,70,275,1.928571429,24,62,1.583333333,94,337,3.585106383,27,81,2,14,27,0.928571429,41,108,2.634146341,7,11,1.571428571
POA4737,873,1705,1.95303551,649,2656,2.092449923,246,796,2.235772358,895,3452,3.85698324,166,507,2.054216867,99,200,1.02020202,265,707,2.667924528,29,57,1.965517241
POA4738,139,273,1.964028777,86,339,1.941860465,44,133,2.022727273,130,472,3.630769231,22,66,2,17,25,0.470588235,39,91,2.333333333,3,9,3
POA4739,57,110,1.929824561,30,122,2.066666667,9,25,1.777777778,39,147,3.769230769,8,23,1.875,0,3,#DIV/0!,8,26,3.25,0,0,#DIV/0!
POA4740,8082,15574,1.926998268,6972,27982,2.013482501,2690,8595,2.195167286,9662,36577,3.785655144,1732,5086,1.936489607,1261,2771,1.197462331,2993,7857,2.625125292,317,655,2.066246057
POA4741,933,1806,1.935691318,695,2872,2.132374101,307,960,2.127035831,1002,3832,3.824351297,111,348,2.135135135,77,159,1.064935065,188,507,2.696808511,13,26,2
POA4742,124,242,1.951612903,118,452,1.830508475,32,97,2.03125,150,549,3.66,25,88,2.52,14,28,1,39,116,2.974358974,4,6,1.5
POA4743,79,159,2.012658228,183,757,2.136612022,20,68,2.4,203,825,4.064039409,14,31,1.214285714,7,15,1.142857143,21,46,2.19047619,3,5,1.666666667
POA4744,626,1209,1.931309904,1089,4475,2.109274564,206,669,2.247572816,1295,5144,3.972200772,111,319,1.873873874,82,173,1.109756098,193,492,2.549222798,8,22,2.75
POA4745,236,462,1.957627119,325,1353,2.163076923,64,208,2.25,389,1561,4.01285347,20,59,1.95,19,45,1.368421053,39,104,2.666666667,4,8,2
POA4746,151,297,1.966887417,236,981,2.156779661,36,108,2,272,1089,4.003676471,19,40,1.105263158,8,20,1.5,27,60,2.222222222,4,5,1.25
POA4750,523,996,1.904397706,582,2305,1.9604811,169,526,2.112426036,751,2831,3.769640479,125,360,1.88,57,122,1.140350877,182,482,2.648351648,9,16,1.777777778
POA4751,454,863,1.900881057,473,1915,2.048625793,152,485,2.190789474,625,2400,3.84,72,212,1.944444444,59,122,1.06779661,131,334,2.549618321,17,40,2.352941176
POA4753,300,575,1.916666667,367,1447,1.942779292,94,305,2.244680851,461,1752,3.800433839,35,101,1.885714286,34,78,1.294117647,69,179,2.594202899,12,19,1.583333333
POA4754,204,388,1.901960784,192,828,2.3125,67,215,2.208955224,259,1043,4.027027027,41,107,1.609756098,12,32,1.666666667,53,139,2.622641509,8,14,1.75
POA4756,64,127,1.984375,47,209,2.446808511,10,24,1.4,57,233,4.087719298,9,37,3.111111111,3,3,0,12,40,3.333333333,0,0,#DIV/0!
POA4757,70,130,1.857142857,31,134,2.322580645,6,16,1.666666667,37,150,4.054054054,14,48,2.428571429,4,7,0.75,18,55,3.055555556,0,3,#DIV/0!
POA4798,81,153,1.888888889,42,172,2.095238095,20,58,1.9,62,230,3.709677419,7,31,3.428571429,5,9,0.8,12,40,3.333333333,0,0,#DIV/0!
POA4799,120,230,1.916666667,63,279,2.428571429,19,55,1.894736842,82,334,4.073170732,29,73,1.517241379,14,33,1.357142857,43,106,2.465116279,0,0,#DIV/0!
POA4800,1112,2159,1.941546763,759,2998,1.949934124,262,812,2.099236641,1021,3810,3.731635651,205,598,1.917073171,99,208,1.101010101,304,806,2.651315789,25,54,2.16
POA4801,0,0,#DIV/0!,0,0,#DIV/0!,0,0,#DIV/0!,0,0,#DIV/0!,0,0,#DIV/0!,0,0,#DIV/0!,0,0,#DIV/0!,0,0,#DIV/0!
POA4802,997,1928,1.933801404,593,2191,1.694772344,117,355,2.034188034,710,2546,3.585915493,208,550,1.644230769,93,186,1,301,736,2.445182724,25,48,1.92
POA4803,60,115,1.916666667,29,109,1.75862069,0,6,#DIV/0!,29,115,3.965517241,3,9,2,0,0,#DIV/0!,3,9,3,0,0,#DIV/0!
POA4804,268,519,1.936567164,179,694,1.877094972,57,180,2.157894737,236,874,3.703389831,33,93,1.818181818,31,66,1.129032258,64,159,2.484375,5,14,2.8
POA4805,1167,2298,1.969151671,716,2973,2.152234637,299,944,2.157190635,1015,3917,3.8591133,236,696,1.949152542,150,336,1.24,386,1032,2.67357513,34,62,1.823529412
POA4806,489,968,1.979550102,328,1376,2.195121951,143,435,2.041958042,471,1811,3.845010616,77,245,2.181818182,59,121,1.050847458,136,366,2.691176471,9,20,2.222222222
POA4807,1277,2524,1.976507439,866,3615,2.174364896,370,1186,2.205405405,1236,4801,3.884304207,268,827,2.085820896,179,395,1.206703911,447,1222,2.733780761,41,82,2
POA4808,154,307,1.993506494,110,460,2.181818182,50,164,2.28,160,624,3.9,26,84,2.230769231,18,33,0.833333333,44,117,2.659090909,5,8,1.6
POA4809,128,245,1.9140625,81,339,2.185185185,24,82,2.416666667,105,421,4.00952381,17,45,1.647058824,8,23,1.875,25,68,2.72,3,5,1.666666667
POA4810,2405,4594,1.91018711,1189,4600,1.868797309,455,1448,2.182417582,1644,6048,3.678832117,496,1261,1.54233871,331,720,1.175226586,827,1981,2.395405079,115,243,2.113043478
POA4811,1108,2140,1.931407942,969,3905,2.029927761,354,1144,2.231638418,1323,5049,3.816326531,312,931,1.983974359,198,444,1.242424242,510,1375,2.696078431,69,139,2.014492754
POA4812,1907,3736,1.95909806,1213,4747,1.913437758,468,1531,2.271367521,1681,6278,3.734681737,612,1651,1.697712418,461,1000,1.169197397,1073,2651,2.470643057,157,331,2.108280255
POA4813,0,0,#DIV/0!,0,0,#DIV/0!,0,0,#DIV/0!,0,0,#DIV/0!,0,0,#DIV/0!,0,0,#DIV/0!,0,0,#DIV/0!,0,0,#DIV/0!
POA4814,3974,7755,1.951434323,3756,15051,2.007188498,1423,4681,2.289529164,5179,19732,3.810001931,1145,3515,2.069868996,851,1905,1.238542891,1996,5420,2.715430862,241,512,2.124481328
POA4815,1895,3696,1.950395778,1904,7847,2.121323529,637,2082,2.26844584,2541,9929,3.907516726,728,2392,2.285714286,327,749,1.290519878,1055,3141,2.977251185,74,161,2.175675676
POA4816,998,1992,1.995991984,616,2792,2.532467532,236,765,2.241525424,852,3557,4.174882629,232,808,2.482758621,127,344,1.708661417,359,1152,3.208913649,45,108,2.4
POA4817,2756,5316,1.928882438,2993,12097,2.041764116,1025,3413,2.329756098,4018,15510,3.860129418,807,2341,1.90086741,472,1065,1.256355932,1279,3406,2.663017983,104,222,2.134615385
POA4818,2140,4107,1.919158879,2111,8460,2.007579346,603,1936,2.210613599,2714,10396,3.830508475,450,1384,2.075555556,237,528,1.227848101,687,1912,2.783114993,44,96,2.181818182
POA4819,290,569,1.962068966,117,477,2.076923077,57,173,2.035087719,174,650,3.735632184,59,156,1.644067797,50,103,1.06,109,259,2.376146789,4,8,2
POA4820,1103,2139,1.939256573,842,3515,2.174584323,285,879,2.084210526,1127,4394,3.898846495,298,912,2.060402685,176,380,1.159090909,474,1292,2.725738397,33,67,2.03030303
POA4821,189,371,1.962962963,121,492,2.066115702,30,79,1.633333333,151,571,3.781456954,31,84,1.709677419,13,27,1.076923077,44,111,2.522727273,6,11,1.833333333
POA4822,94,188,2,71,285,2.014084507,21,56,1.666666667,92,341,3.706521739,17,35,1.058823529,9,27,2,26,62,2.384615385,3,7,2.333333333
POA4823,81,151,1.864197531,62,240,1.870967742,23,60,1.608695652,85,300,3.529411765,12,34,1.833333333,10,19,0.9,22,53,2.409090909,5,7,1.4
POA4824,235,453,1.927659574,209,864,2.133971292,49,142,1.897959184,258,1006,3.899224806,61,200,2.278688525,29,71,1.448275862,90,271,3.011111111,12,24,2
POA4825,1718,3417,1.988940629,1848,7638,2.133116883,448,1503,2.354910714,2296,9141,3.981271777,525,1676,2.192380952,239,551,1.305439331,764,2227,2.914921466,96,199,2.072916667
POA4828,4,12,3,10,47,2.7,3,4,0.333333333,13,51,3.923076923,13,58,3.461538462,3,6,1,16,64,4,0,0,#DIV/0!
POA4829,65,122,1.876923077,60,245,2.083333333,16,37,1.3125,76,282,3.710526316,13,43,2.307692308,4,14,2.5,17,57,3.352941176,4,14,3.5
POA4830,56,120,2.142857143,143,745,3.20979021,19,66,2.473684211,162,811,5.00617284,61,227,2.721311475,11,26,1.363636364,72,253,3.513888889,13,35,2.692307692
POA4849,231,462,2,83,319,1.843373494,15,44,1.933333333,98,363,3.704081633,27,86,2.185185185,17,36,1.117647059,44,122,2.772727273,4,7,1.75
POA4850,1527,3008,1.969875573,875,3621,2.138285714,407,1275,2.132678133,1282,4896,3.819032761,184,553,2.005434783,190,412,1.168421053,374,965,2.580213904,37,79,2.135135135
POA4852,417,808,1.93764988,226,920,2.07079646,62,190,2.064516129,288,1110,3.854166667,92,269,1.923913043,48,106,1.208333333,140,375,2.678571429,7,15,2.142857143
POA4854,625,1240,1.984,429,1849,2.31002331,161,520,2.229813665,590,2369,4.015254237,104,327,2.144230769,80,176,1.2,184,503,2.733695652,21,53,2.523809524
POA4855,116,231,1.99137931,60,255,2.25,29,88,2.034482759,89,343,3.853932584,22,51,1.318181818,10,17,0.7,32,68,2.125,0,5,#DIV/0!
POA4856,64,127,1.984375,42,172,2.095238095,17,64,2.764705882,59,236,4,12,30,1.5,6,14,1.333333333,18,44,2.444444444,5,4,0.8
POA4857,25,43,1.72,8,38,2.75,6,27,3.5,14,65,4.642857143,0,0,#DIV/0!,7,15,1.142857143,7,15,2.142857143,3,3,1
POA4858,147,283,1.925170068,110,459,2.172727273,46,154,2.347826087,156,613,3.929487179,26,82,2.153846154,27,58,1.148148148,53,140,2.641509434,9,16,1.777777778
POA4859,40,88,2.2,28,114,2.071428571,22,65,1.954545455,50,179,3.58,9,33,2.666666667,9,19,1.111111111,18,52,2.888888889,4,4,1
POA4860,1215,2387,1.964609053,793,3316,2.181588903,369,1177,2.189701897,1162,4493,3.866609294,365,1131,2.098630137,171,389,1.274853801,536,1520,2.835820896,52,112,2.153846154
POA4861,103,198,1.922330097,68,290,2.264705882,34,101,1.970588235,102,391,3.833333333,29,87,2,31,65,1.096774194,60,152,2.533333333,3,10,3.333333333
POA4865,746,1452,1.946380697,689,2874,2.1712627,236,762,2.228813559,925,3636,3.930810811,241,739,2.066390041,115,256,1.226086957,356,995,2.79494382,15,35,2.333333333
POA4868,2127,4133,1.943112365,1752,7163,2.08847032,651,2098,2.222734255,2403,9261,3.853932584,770,2395,2.11038961,388,852,1.195876289,1158,3247,2.803972366,81,174,2.148148148
POA4869,1368,2673,1.953947368,1775,7420,2.18028169,432,1412,2.268518519,2207,8832,4.001812415,719,2305,2.205841446,245,556,1.269387755,964,2861,2.967842324,50,103,2.06
POA4870,6145,11911,1.938323841,4883,19446,1.982387876,1448,4633,2.199585635,6331,24079,3.803348602,2136,6150,1.879213483,1190,2616,1.198319328,3326,8766,2.635598316,338,721,2.133136095
POA4871,1411,2848,2.018426648,1215,5599,2.608230453,347,1170,2.371757925,1562,6769,4.333546735,621,2264,2.645732689,280,733,1.617857143,901,2997,3.326304107,104,267,2.567307692
POA4872,481,950,1.975051975,282,1172,2.156028369,100,312,2.12,382,1484,3.884816754,83,251,2.024096386,49,101,1.06122449,132,352,2.666666667,16,38,2.375
POA4873,662,1309,1.97734139,493,1997,2.050709939,148,446,2.013513514,641,2443,3.811232449,161,483,2,93,204,1.193548387,254,687,2.704724409,20,42,2.1
POA4874,344,671,1.950581395,437,1866,2.270022883,82,286,2.487804878,519,2152,4.146435453,113,363,2.212389381,67,172,1.567164179,180,535,2.972222222,26,56,2.153846154
POA4875,278,565,2.032374101,673,3181,2.726597325,109,374,2.431192661,782,3555,4.546035806,372,1254,2.370967742,100,250,1.5,472,1504,3.186440678,50,114,2.28
POA4876,88,180,2.045454545,211,1088,3.156398104,30,95,2.166666667,241,1183,4.908713693,112,432,2.857142857,41,102,1.487804878,153,534,3.490196078,14,38,2.714285714
POA4877,608,1188,1.953947368,287,1069,1.724738676,69,212,2.072463768,356,1281,3.598314607,92,216,1.347826087,46,95,1.065217391,138,311,2.253623188,12,28,2.333333333
POA4878,1302,2538,1.949308756,850,3272,1.849411765,306,980,2.202614379,1156,4252,3.678200692,371,1002,1.700808625,232,496,1.137931034,603,1498,2.484245439,47,100,2.127659574
POA4879,2226,4311,1.936657682,1493,5773,1.866711319,441,1395,2.163265306,1934,7168,3.70630817,493,1365,1.768762677,253,536,1.118577075,746,1901,2.548257373,42,85,2.023809524
POA4880,1302,2550,1.958525346,904,3815,2.220132743,328,1031,2.143292683,1232,4846,3.933441558,323,1008,2.120743034,211,470,1.227488152,534,1478,2.767790262,50,116,2.32
POA4881,541,1043,1.927911275,304,1258,2.138157895,104,333,2.201923077,408,1591,3.899509804,139,425,2.057553957,76,184,1.421052632,215,609,2.83255814,18,31,1.722222222
POA4882,351,676,1.925925926,204,850,2.166666667,63,206,2.26984127,267,1056,3.95505618,45,134,1.977777778,35,68,0.942857143,80,202,2.525,7,16,2.285714286
POA4883,964,1889,1.959543568,562,2377,2.229537367,184,589,2.201086957,746,2966,3.975871314,287,862,2.003484321,148,305,1.060810811,435,1167,2.682758621,31,64,2.064516129
POA4884,243,462,1.901234568,128,522,2.078125,36,106,1.944444444,164,628,3.829268293,35,87,1.485714286,25,58,1.32,60,145,2.416666667,4,6,1.5
POA4885,523,1018,1.946462715,266,1094,2.112781955,97,300,2.092783505,363,1394,3.840220386,84,277,2.297619048,62,131,1.112903226,146,408,2.794520548,8,19,2.375
POA4886,120,228,1.9,44,191,2.340909091,29,78,1.689655172,73,269,3.684931507,31,102,2.290322581,13,27,1.076923077,44,129,2.931818182,0,3,#DIV/0!
POA4887,262,509,1.942748092,119,503,2.226890756,52,158,2.038461538,171,661,3.865497076,64,187,1.921875,48,99,1.0625,112,286,2.553571429,8,14,1.75
POA4888,357,695,1.946778711,171,777,2.543859649,66,205,2.106060606,237,982,4.143459916,92,284,2.086956522,46,94,1.043478261,138,378,2.739130435,6,11,1.833333333
POA4890,116,242,2.086206897,100,439,2.39,14,44,2.142857143,114,483,4.236842105,45,142,2.155555556,8,22,1.75,53,164,3.094339623,7,24,3.428571429
POA4891,88,173,1.965909091,35,135,1.857142857,9,28,2.111111111,44,163,3.704545455,10,17,0.7,7,11,0.571428571,17,28,1.647058824,0,0,#DIV/0!
POA4895,368,727,1.975543478,316,1378,2.360759494,54,168,2.111111111,370,1546,4.178378378,135,404,1.992592593,73,187,1.561643836,208,591,2.841346154,31,89,2.870967742
POA5000,1267,2484,1.960536701,266,909,1.417293233,102,332,2.254901961,368,1241,3.372282609,103,240,1.330097087,143,293,1.048951049,246,533,2.166666667,170,349,2.052941176
POA5005,0,0,#DIV/0!,0,0,#DIV/0!,0,0,#DIV/0!,0,0,#DIV/0!,0,0,#DIV/0!,0,0,#DIV/0!,0,0,#DIV/0!,0,0,#DIV/0!
POA5006,851,1649,1.937720329,254,933,1.673228346,104,332,2.192307692,358,1265,3.533519553,50,134,1.68,61,132,1.163934426,111,266,2.396396396,62,129,2.080645161
POA5007,613,1210,1.973898858,365,1369,1.750684932,142,482,2.394366197,507,1851,3.650887574,148,413,1.790540541,159,338,1.125786164,307,751,2.446254072,58,117,2.017241379
POA5008,1160,2327,2.006034483,961,3813,1.967741935,454,1533,2.376651982,1415,5346,3.778091873,316,930,1.943037975,397,911,1.294710327,713,1841,2.582047686,106,231,2.179245283
POA5009,464,935,2.015086207,396,1601,2.042929293,172,588,2.418604651,568,2189,3.853873239,100,296,1.96,117,265,1.264957265,217,561,2.585253456,36,80,2.222222222
POA5010,396,788,1.98989899,467,1870,2.004282655,174,617,2.545977011,641,2487,3.879875195,158,485,2.069620253,137,331,1.416058394,295,816,2.766101695,37,79,2.135135135
POA5011,805,1591,1.976397516,801,3177,1.966292135,388,1345,2.466494845,1189,4522,3.803195963,194,539,1.778350515,283,665,1.349823322,477,1204,2.524109015,53,122,2.301886792
POA5012,711,1446,2.033755274,764,3162,2.138743455,317,1100,2.470031546,1081,4262,3.942645698,329,1031,2.133738602,265,616,1.324528302,594,1647,2.772727273,66,153,2.318181818
POA5013,741,1491,2.012145749,691,2816,2.075253256,317,1099,2.466876972,1008,3915,3.883928571,331,958,1.894259819,334,774,1.317365269,665,1732,2.604511278,72,160,2.222222222
POA5014,1115,2225,1.995515695,778,3096,1.979434447,445,1519,2.413483146,1223,4615,3.773507768,318,857,1.694968553,329,725,1.203647416,647,1582,2.445131376,60,125,2.083333333
POA5015,602,1191,1.978405316,355,1387,1.907042254,151,495,2.278145695,506,1882,3.719367589,173,463,1.676300578,181,390,1.154696133,354,853,2.40960452,31,68,2.193548387
POA5016,883,1757,1.989807475,606,2376,1.920792079,311,1042,2.350482315,917,3418,3.727371865,185,503,1.718918919,200,454,1.27,385,957,2.485714286,38,77,2.026315789
POA5017,479,953,1.989561587,277,1140,2.115523466,170,558,2.282352941,447,1698,3.798657718,228,681,1.986842105,189,416,1.201058201,417,1097,2.630695444,37,78,2.108108108
POA5018,735,1453,1.976870748,421,1651,1.921615202,340,1139,2.35,761,2790,3.666228647,96,268,1.791666667,107,249,1.327102804,203,517,2.54679803,16,32,2
POA5019,954,1887,1.977987421,539,2106,1.907235622,317,1042,2.287066246,856,3148,3.677570093,257,696,1.708171206,243,535,1.201646091,500,1231,2.462,42,88,2.095238095
POA5020,424,831,1.95990566,188,758,2.031914894,176,590,2.352272727,364,1348,3.703296703,41,121,1.951219512,54,126,1.333333333,95,247,2.6,8,12,1.5
POA5021,949,1884,1.985247629,297,1186,1.993265993,322,1086,2.372670807,619,2272,3.670436187,67,166,1.47761194,115,256,1.226086957,182,422,2.318681319,25,41,1.64
POA5022,1669,3266,1.956860395,1130,4414,1.90619469,587,1982,2.37649063,1717,6396,3.725101922,231,592,1.562770563,287,640,1.229965157,518,1232,2.378378378,64,136,2.125
POA5023,1627,3228,1.984019668,1016,4053,1.989173228,597,2050,2.433835846,1613,6103,3.783632982,422,1240,1.938388626,489,1100,1.249488753,911,2340,2.568605928,81,182,2.24691358
POA5024,1636,3244,1.982885086,931,3702,1.976369495,633,2181,2.44549763,1564,5883,3.761508951,177,475,1.683615819,239,548,1.292887029,416,1023,2.459134615,58,115,1.982758621
POA5025,975,1943,1.992820513,587,2344,1.99318569,390,1362,2.492307692,977,3706,3.793244626,131,396,2.022900763,191,429,1.246073298,322,825,2.562111801,42,91,2.166666667
POA5031,914,1817,1.987964989,641,2522,1.934477379,271,929,2.42804428,912,3451,3.783991228,158,426,1.696202532,246,558,1.268292683,404,984,2.435643564,100,212,2.12
POA5032,1279,2533,1.980453479,929,3598,1.872981701,450,1541,2.424444444,1379,5139,3.726613488,205,561,1.736585366,265,602,1.271698113,470,1163,2.474468085,87,170,1.954022989
POA5033,754,1503,1.9933687,488,1926,1.946721311,216,726,2.361111111,704,2652,3.767045455,166,432,1.602409639,197,435,1.208121827,363,867,2.388429752,77,163,2.116883117
POA5034,1000,1974,1.974,751,2943,1.918774967,337,1125,2.338278932,1088,4068,3.738970588,123,306,1.487804878,156,349,1.237179487,279,655,2.347670251,64,138,2.15625
POA5035,598,1176,1.966555184,447,1749,1.912751678,155,520,2.35483871,602,2269,3.76910299,96,223,1.322916667,102,210,1.058823529,198,433,2.186868687,47,100,2.127659574
POA5037,1101,2183,1.982742961,729,2855,1.916323731,280,956,2.414285714,1009,3811,3.777006938,153,429,1.803921569,225,509,1.262222222,378,938,2.481481481,88,182,2.068181818
POA5038,1566,3098,1.978288633,1038,3972,1.826589595,395,1334,2.37721519,1433,5306,3.702721563,242,639,1.640495868,347,756,1.178674352,589,1395,2.368421053,107,226,2.112149533
POA5039,778,1544,1.984575835,633,2456,1.879936809,263,905,2.441064639,896,3361,3.751116071,159,440,1.767295597,240,526,1.191666667,399,966,2.421052632,48,99,2.0625
POA5040,315,620,1.968253968,154,604,1.922077922,102,343,2.362745098,256,947,3.69921875,35,106,2.028571429,51,111,1.176470588,86,217,2.523255814,9,17,1.888888889
POA5041,1175,2324,1.97787234,1228,4908,1.996742671,543,1845,2.397790055,1771,6753,3.813099944,193,514,1.663212435,255,573,1.247058824,448,1087,2.426339286,62,130,2.096774194
POA5042,1124,2225,1.979537367,730,2841,1.891780822,326,1086,2.331288344,1056,3927,3.71875,162,461,1.845679012,219,498,1.273972603,381,959,2.517060367,55,124,2.254545455
POA5043,1906,3776,1.981112277,1034,4046,1.912959381,464,1590,2.426724138,1498,5636,3.7623498,390,1053,1.7,484,1062,1.194214876,874,2115,2.419908467,138,282,2.043478261
POA5044,1143,2241,1.960629921,732,2912,1.978142077,402,1353,2.365671642,1134,4265,3.761022928,138,370,1.68115942,205,434,1.117073171,343,804,2.344023324,47,96,2.042553191
POA5045,1881,3693,1.963317384,886,3426,1.866817156,487,1609,2.303901437,1373,5035,3.667152221,194,484,1.494845361,296,618,1.087837838,490,1102,2.248979592,75,151,2.013333333
POA5046,943,1862,1.974549311,454,1797,1.95814978,260,861,2.311538462,714,2658,3.722689076,162,432,1.666666667,235,497,1.114893617,397,929,2.340050378,57,107,1.877192982
POA5047,853,1683,1.973036342,501,1966,1.924151697,243,798,2.283950617,744,2764,3.715053763,214,614,1.869158879,241,509,1.112033195,455,1123,2.468131868,53,111,2.094339623
POA5048,1535,3002,1.955700326,912,3586,1.932017544,497,1656,2.331991952,1409,5242,3.720369056,255,663,1.6,323,684,1.117647059,578,1347,2.330449827,56,125,2.232142857
POA5049,1236,2438,1.972491909,695,2714,1.905035971,430,1421,2.304651163,1125,4135,3.675555556,141,392,1.780141844,198,427,1.156565657,339,819,2.415929204,32,61,1.90625
POA5050,709,1401,1.976022567,417,1643,1.940047962,262,881,2.36259542,679,2524,3.717231222,68,189,1.779411765,100,229,1.29,168,418,2.488095238,17,41,2.411764706
POA5051,1480,2913,1.968243243,1328,5314,2.001506024,601,2032,2.381031614,1929,7346,3.808190772,187,494,1.64171123,235,513,1.182978723,422,1007,2.386255924,36,72,2
POA5052,789,1546,1.959442332,539,2134,1.959183673,332,1117,2.364457831,871,3251,3.732491389,85,217,1.552941176,106,243,1.29245283,191,460,2.408376963,18,43,2.388888889
POA5061,1033,2023,1.958373669,788,3108,1.944162437,347,1172,2.377521614,1135,4280,3.77092511,114,292,1.561403509,184,411,1.233695652,298,703,2.359060403,49,103,2.102040816
POA5062,1496,2935,1.961898396,1191,4815,2.042821159,706,2411,2.415014164,1897,7226,3.809172377,218,568,1.605504587,297,653,1.198653199,515,1221,2.370873786,62,134,2.161290323
POA5063,1090,2129,1.953211009,888,3464,1.900900901,372,1279,2.438172043,1260,4743,3.764285714,194,483,1.489690722,244,514,1.106557377,438,997,2.276255708,60,120,2
POA5064,1079,2125,1.969416126,681,2760,2.052863436,440,1493,2.393181818,1121,4253,3.793933988,123,344,1.796747967,165,385,1.333333333,288,729,2.53125,40,82,2.05
POA5065,1030,2004,1.945631068,709,2844,2.011283498,383,1309,2.417754569,1092,4153,3.803113553,118,287,1.43220339,162,350,1.160493827,280,637,2.275,36,81,2.25
POA5066,1278,2509,1.963223787,956,3870,2.048117155,558,1923,2.446236559,1514,5793,3.826287979,156,420,1.692307692,215,484,1.251162791,371,904,2.436657682,49,106,2.163265306
POA5067,1137,2223,1.955145119,552,2063,1.737318841,232,748,2.224137931,784,2811,3.585459184,136,347,1.551470588,200,430,1.15,336,777,2.3125,87,177,2.034482759
POA5068,1192,2354,1.974832215,814,3212,1.945945946,437,1518,2.473684211,1251,4730,3.78097522,216,562,1.601851852,237,519,1.189873418,453,1081,2.386313466,72,146,2.027777778
POA5069,812,1588,1.955665025,632,2482,1.92721519,318,1106,2.477987421,950,3588,3.776842105,114,288,1.526315789,164,359,1.18902439,278,647,2.327338129,60,123,2.05
POA5070,1543,3051,1.977316915,969,3736,1.855521156,433,1478,2.413394919,1402,5214,3.718972896,227,599,1.63876652,311,677,1.176848875,538,1276,2.371747212,112,246,2.196428571
POA5072,1292,2560,1.981424149,877,3500,1.990877993,561,1871,2.335115865,1438,5371,3.735048679,200,531,1.655,271,618,1.280442804,471,1149,2.439490446,54,114,2.111111111
POA5073,1610,3203,1.989440994,1179,4641,1.936386768,652,2235,2.42791411,1831,6876,3.755324959,231,620,1.683982684,362,821,1.267955801,593,1441,2.430016863,78,165,2.115384615
POA5074,1294,2586,1.998454405,928,3703,1.990301724,472,1619,2.430084746,1400,5322,3.801428571,251,735,1.928286853,299,688,1.301003344,550,1423,2.587272727,74,162,2.189189189
POA5075,1191,2354,1.976490344,783,3150,2.022988506,467,1622,2.473233405,1250,4772,3.8176,165,503,2.048484848,237,528,1.227848101,402,1031,2.564676617,60,123,2.05
POA5076,977,1942,1.987717503,810,3286,2.056790123,597,2111,2.5360134,1407,5397,3.835820896,147,404,1.74829932,187,420,1.245989305,334,824,2.467065868,25,54,2.16
POA5081,941,1862,1.978746015,608,2456,2.039473684,360,1212,2.366666667,968,3668,3.789256198,112,308,1.75,136,285,1.095588235,248,593,2.391129032,59,125,2.118644068
POA5082,1346,2676,1.988112927,1211,4699,1.880264244,538,1859,2.455390335,1749,6558,3.749571184,215,555,1.581395349,297,681,1.292929293,512,1236,2.4140625,94,194,2.063829787
POA5083,657,1306,1.98782344,599,2327,1.884808013,254,867,2.413385827,853,3194,3.744431419,119,316,1.655462185,150,327,1.18,269,643,2.390334572,50,103,2.06
POA5084,677,1362,2.011816839,687,2817,2.100436681,240,869,2.620833333,927,3686,3.97626753,314,994,2.165605096,285,648,1.273684211,599,1642,2.741235392,72,165,2.291666667
POA5085,1378,2749,1.994920174,1214,4818,1.968698517,398,1348,2.386934673,1612,6166,3.825062035,387,1123,1.901808786,339,788,1.324483776,726,1911,2.632231405,106,233,2.198113208
POA5086,1524,3024,1.984251969,1202,4657,1.87437604,423,1442,2.408983452,1625,6099,3.753230769,385,1146,1.976623377,371,848,1.285714286,756,1994,2.637566138,89,186,2.08988764
POA5087,1232,2447,1.986201299,706,2702,1.827195467,290,978,2.372413793,996,3680,3.694779116,247,686,1.777327935,276,615,1.22826087,523,1301,2.487571702,76,156,2.052631579
POA5088,340,688,2.023529412,192,777,2.046875,111,368,2.315315315,303,1145,3.778877888,101,294,1.910891089,127,284,1.236220472,228,578,2.535087719,12,24,2
POA5089,794,1567,1.973551637,577,2323,2.025996534,352,1199,2.40625,929,3522,3.791173305,118,342,1.898305085,118,291,1.466101695,236,633,2.68220339,23,48,2.086956522
POA5090,942,1870,1.985138004,483,1913,1.960662526,297,1000,2.367003367,780,2913,3.734615385,155,427,1.75483871,153,355,1.320261438,308,782,2.538961039,23,51,2.217391304
POA5091,968,1927,1.990702479,626,2516,2.019169329,339,1132,2.339233038,965,3648,3.780310881,129,338,1.620155039,142,319,1.246478873,271,657,2.424354244,24,51,2.125
POA5092,1822,3603,1.977497256,1243,4943,1.976669348,704,2350,2.338068182,1947,7293,3.745762712,338,968,1.863905325,409,920,1.249388753,747,1888,2.527443106,49,107,2.183673469
POA5093,1106,2198,1.987341772,653,2682,2.10719755,330,1107,2.354545455,983,3789,3.854526958,239,702,1.937238494,235,523,1.225531915,474,1225,2.584388186,44,99,2.25
POA5094,82,167,2.036585366,53,208,1.924528302,31,111,2.580645161,84,319,3.797619048,23,70,2.043478261,18,38,1.111111111,41,108,2.634146341,3,12,4
POA5095,1797,3568,1.985531441,1620,6330,1.907407407,606,2073,2.420792079,2226,8403,3.774932615,370,1030,1.783783784,327,763,1.333333333,697,1793,2.572453372,102,219,2.147058824
POA5096,1477,2916,1.974272173,1159,4743,2.092320966,647,2200,2.400309119,1806,6943,3.84440753,387,1117,1.88630491,338,779,1.304733728,725,1896,2.615172414,66,144,2.181818182
POA5097,1570,3108,1.979617834,1057,4192,1.965941343,621,2125,2.421900161,1678,6317,3.764600715,287,748,1.606271777,290,638,1.2,577,1386,2.402079723,44,89,2.022727273
POA5098,1372,2723,1.984693878,928,3752,2.043103448,454,1544,2.400881057,1382,5296,3.832127352,314,910,1.898089172,284,633,1.228873239,598,1543,2.580267559,60,132,2.2
POA5106,0,0,#DIV/0!,0,0,#DIV/0!,0,0,#DIV/0!,0,0,#DIV/0!,0,0,#DIV/0!,0,0,#DIV/0!,0,0,#DIV/0!,0,0,#DIV/0!
POA5107,1295,2579,1.991505792,1258,5250,2.173290938,681,2385,2.502202643,1939,7635,3.937596699,485,1489,2.070103093,403,965,1.394540943,888,2454,2.763513514,88,188,2.136363636
POA5108,3125,6241,1.99712,2871,11868,2.133751306,1406,4842,2.443812233,4277,16710,3.90694412,1500,4433,1.955333333,1042,2349,1.254318618,2542,6782,2.66797797,181,377,2.082872928
POA5109,2174,4324,1.988960442,1480,6061,2.09527027,888,3016,2.396396396,2368,9077,3.833192568,588,1671,1.841836735,487,1108,1.275154004,1075,2779,2.585116279,76,157,2.065789474
POA5110,760,1512,1.989473684,760,3121,2.106578947,290,984,2.393103448,1050,4105,3.90952381,258,789,2.058139535,136,320,1.352941176,394,1109,2.814720812,26,57,2.192307692
POA5111,0,0,#DIV/0!,0,0,#DIV/0!,0,0,#DIV/0!,0,0,#DIV/0!,0,5,#DIV/0!,0,0,#DIV/0!,0,5,#DIV/0!,0,0,#DIV/0!
POA5112,1624,3233,1.990763547,1109,4710,2.247069432,601,2002,2.331114809,1710,6712,3.925146199,864,2546,1.946759259,560,1234,1.203571429,1424,3780,2.654494382,106,223,2.103773585
POA5113,1463,2935,2.006151743,1057,4601,2.352885525,428,1414,2.303738318,1485,6015,4.050505051,1130,3435,2.039823009,628,1394,1.219745223,1758,4829,2.746871445,120,253,2.108333333
POA5114,2621,5201,1.984357116,2632,10960,2.164133739,1045,3496,2.345454545,3677,14456,3.931465869,1129,3387,2,537,1214,1.260707635,1666,4601,2.761704682,94,192,2.042553191
POA5115,604,1209,2.001655629,627,2524,2.025518341,190,644,2.389473684,817,3168,3.877600979,307,948,2.087947883,133,298,1.240601504,440,1246,2.831818182,23,49,2.130434783
POA5116,873,1728,1.979381443,577,2277,1.94627383,293,975,2.327645051,870,3252,3.737931034,261,756,1.896551724,169,391,1.313609467,430,1147,2.66744186,21,48,2.285714286
POA5117,202,391,1.935643564,304,1293,2.253289474,112,382,2.410714286,416,1675,4.026442308,22,72,2.272727273,15,41,1.733333333,37,113,3.054054054,4,0,0
POA5118,1887,3722,1.972443031,1447,5908,2.0829302,692,2283,2.299132948,2139,8191,3.829359514,424,1170,1.759433962,336,721,1.145833333,760,1891,2.488157895,49,98,2
POA5120,165,334,2.024242424,145,581,2.006896552,103,386,2.747572816,248,967,3.899193548,32,95,1.96875,26,63,1.423076923,58,158,2.724137931,3,3,1
POA5121,200,402,2.01,74,304,2.108108108,68,246,2.617647059,142,550,3.873239437,22,59,1.681818182,14,35,1.5,36,94,2.611111111,0,4,#DIV/0!
POA5125,1819,3597,1.977460143,1794,7246,2.039018952,903,3112,2.446290144,2697,10358,3.840563589,417,1160,1.78177458,367,820,1.234332425,784,1980,2.525510204,43,87,2.023255814
POA5126,881,1755,1.992054484,632,2464,1.898734177,309,1023,2.310679612,941,3487,3.705632306,146,406,1.780821918,160,365,1.28125,306,771,2.519607843,25,50,2
POA5127,807,1600,1.982651797,660,2603,1.943939394,468,1624,2.47008547,1128,4227,3.747340426,178,485,1.724719101,192,435,1.265625,370,920,2.486486486,23,53,2.304347826
POA5131,104,208,2,76,322,2.236842105,66,231,2.5,142,553,3.894366197,6,21,2.5,3,4,0.333333333,9,25,2.777777778,0,0,#DIV/0!
POA5132,52,112,2.153846154,29,118,2.068965517,16,51,2.1875,45,169,3.755555556,4,8,1,4,10,1.5,8,18,2.25,0,0,#DIV/0!
POA5133,53,110,2.075471698,49,206,2.204081633,33,116,2.515151515,82,322,3.926829268,3,6,1,6,11,0.833333333,9,17,1.888888889,0,0,#DIV/0!
POA5134,76,150,1.973684211,45,186,2.133333333,8,39,3.875,53,225,4.245283019,4,11,1.75,3,7,1.333333333,7,18,2.571428571,3,3,1
POA5136,43,82,1.906976744,55,222,2.036363636,23,85,2.695652174,78,307,3.935897436,5,13,1.6,9,25,1.777777778,14,38,2.714285714,3,11,3.666666667
POA5137,55,104,1.890909091,43,179,2.162790698,25,89,2.56,68,268,3.941176471,7,18,1.571428571,5,13,1.6,12,31,2.583333333,0,0,#DIV/0!
POA5138,44,82,1.863636364,40,165,2.125,19,62,2.263157895,59,227,3.847457627,7,14,1,0,7,#DIV/0!,7,21,3,0,0,#DIV/0!
POA5139,22,46,2.090909091,18,69,1.833333333,3,11,2.666666667,21,80,3.80952381,3,5,0.666666667,0,3,#DIV/0!,3,8,2.666666667,0,0,#DIV/0!
POA5140,48,97,2.020833333,53,209,1.943396226,17,66,2.882352941,70,275,3.928571429,10,23,1.3,9,15,0.666666667,19,38,2,0,0,#DIV/0!
POA5141,71,138,1.943661972,63,253,2.015873016,50,168,2.36,113,421,3.725663717,0,9,#DIV/0!,8,21,1.625,8,30,3.75,0,0,#DIV/0!
POA5142,67,125,1.865671642,45,183,2.066666667,27,106,2.925925926,72,289,4.013888889,5,16,2.2,11,23,1.090909091,16,39,2.4375,0,0,#DIV/0!
POA5144,54,99,1.833333333,28,123,2.392857143,32,107,2.34375,60,230,3.833333333,7,15,1.142857143,6,18,2,13,33,2.538461538,3,6,2
POA5151,38,78,2.052631579,35,134,1.828571429,15,67,3.466666667,50,201,4.02,6,8,0.333333333,6,15,1.5,12,23,1.916666667,0,0,#DIV/0!
POA5152,679,1326,1.95287187,569,2318,2.073813708,311,1002,2.221864952,880,3320,3.772727273,74,178,1.405405405,98,213,1.173469388,172,391,2.273255814,7,15,2.142857143
POA5153,716,1398,1.952513966,643,2614,2.065318818,315,1041,2.304761905,958,3655,3.815240084,87,245,1.816091954,82,176,1.146341463,169,421,2.49112426,11,25,2.272727273
POA5154,356,706,1.983146067,280,1148,2.1,201,676,2.36318408,481,1824,3.792099792,39,106,1.717948718,50,116,1.32,89,222,2.494382022,12,22,1.833333333
POA5155,400,778,1.945,358,1396,1.899441341,152,508,2.342105263,510,1904,3.733333333,88,244,1.772727273,80,181,1.2625,168,425,2.529761905,6,15,2.5
POA5156,113,222,1.96460177,109,429,1.935779817,45,146,2.244444444,154,575,3.733766234,13,36,1.769230769,16,35,1.1875,29,71,2.448275862,3,7,2.333333333
POA5157,334,654,1.958083832,230,963,2.186956522,179,592,2.30726257,409,1555,3.80195599,25,78,2.12,34,69,1.029411765,59,147,2.491525424,11,17,1.545454545
POA5158,2509,4954,1.974491829,2299,9016,1.921705089,1245,4228,2.395983936,3544,13244,3.737020316,451,1236,1.740576497,488,1096,1.245901639,939,2332,2.483493078,57,121,2.122807018
POA5159,3632,7177,1.976046256,3007,12054,2.008646492,1765,6029,2.415864023,4772,18083,3.789396479,608,1683,1.768092105,611,1368,1.238952537,1219,3051,2.502871206,75,157,2.093333333
POA5160,4,11,2.75,0,3,#DIV/0!,0,0,#DIV/0!,0,3,#DIV/0!,0,0,#DIV/0!,0,0,#DIV/0!,0,0,#DIV/0!,0,0,#DIV/0!
POA5161,1095,2173,1.984474886,768,3039,1.95703125,402,1341,2.335820896,1170,4380,3.743589744,250,687,1.748,232,509,1.193965517,482,1196,2.481327801,46,95,2.065217391
POA5162,3622,7176,1.981225842,2613,10513,2.023344814,1316,4429,2.36550152,3929,14942,3.803003309,1012,2806,1.772727273,784,1753,1.235969388,1796,4559,2.538418708,131,283,2.160305344
POA5163,1406,2772,1.971550498,1009,4116,2.079286422,551,1839,2.337568058,1560,5955,3.817307692,526,1533,1.914448669,382,847,1.217277487,908,2380,2.621145374,55,107,1.945454545
POA5164,492,981,1.993902439,296,1219,2.118243243,134,419,2.126865672,430,1638,3.809302326,211,611,1.895734597,163,350,1.147239264,374,961,2.569518717,29,55,1.896551724
POA5165,564,1102,1.953900709,325,1304,2.012307692,143,473,2.307692308,468,1777,3.797008547,179,511,1.854748603,165,352,1.133333333,344,863,2.50872093,29,54,1.862068966
POA5166,227,454,2,132,533,2.037878788,52,165,2.173076923,184,698,3.793478261,76,200,1.631578947,51,115,1.254901961,127,315,2.480314961,11,18,1.636363636
POA5167,649,1293,1.99229584,366,1434,1.918032787,193,644,2.336787565,559,2078,3.717352415,133,362,1.721804511,109,243,1.229357798,242,605,2.5,17,30,1.764705882
POA5168,460,909,1.976086957,352,1427,2.053977273,163,547,2.355828221,515,1974,3.833009709,186,535,1.876344086,132,285,1.159090909,318,820,2.578616352,22,48,2.181818182
POA5169,1525,3025,1.983606557,1164,4681,2.021477663,439,1446,2.293849658,1603,6127,3.822208359,424,1214,1.863207547,287,632,1.202090592,711,1846,2.596343179,45,89,1.977777778
POA5170,136,261,1.919117647,85,327,1.847058824,40,139,2.475,125,466,3.728,30,78,1.6,29,59,1.034482759,59,137,2.322033898,4,6,1.5
POA5171,713,1407,1.973352034,518,2086,2.027027027,212,697,2.287735849,730,2783,3.812328767,104,285,1.740384615,82,182,1.219512195,186,467,2.510752688,9,22,2.444444444
POA5172,487,954,1.958932238,336,1411,2.199404762,188,640,2.404255319,524,2051,3.914122137,75,192,1.56,48,108,1.25,123,300,2.43902439,3,12,4
POA5173,1190,2342,1.968067227,1067,4348,2.07497657,283,928,2.279151943,1350,5276,3.908148148,461,1277,1.770065076,226,493,1.181415929,687,1770,2.576419214,29,57,1.965517241
POA5174,300,586,1.953333333,204,820,2.019607843,88,280,2.181818182,292,1100,3.767123288,86,234,1.720930233,49,109,1.224489796,135,343,2.540740741,3,11,3.666666667
POA5201,222,433,1.95045045,154,636,2.12987013,80,259,2.2375,234,895,3.824786325,36,113,2.138888889,23,48,1.086956522,59,161,2.728813559,4,6,1.5
POA5202,81,160,1.975308642,55,207,1.763636364,17,51,2,72,258,3.583333333,9,32,2.555555556,9,19,1.111111111,18,51,2.833333333,0,4,#DIV/0!
POA5203,147,290,1.972789116,61,241,1.950819672,34,106,2.117647059,95,347,3.652631579,21,60,1.857142857,13,29,1.230769231,34,89,2.617647059,0,4,#DIV/0!
POA5204,450,894,1.986666667,120,466,1.883333333,49,132,1.693877551,169,598,3.538461538,53,139,1.622641509,38,87,1.289473684,91,226,2.483516484,4,6,1.5
POA5210,224,438,1.955357143,173,744,2.300578035,60,206,2.433333333,233,950,4.077253219,31,70,1.258064516,16,36,1.25,47,106,2.255319149,3,5,1.666666667
POA5211,2541,5033,1.980716253,751,3013,2.011984021,297,962,2.239057239,1048,3975,3.792938931,282,807,1.861702128,206,440,1.13592233,488,1247,2.555327869,36,74,2.055555556
POA5212,366,720,1.967213115,110,459,2.172727273,43,136,2.162790698,153,595,3.888888889,36,98,1.722222222,32,63,0.96875,68,161,2.367647059,6,11,1.833333333
POA5213,163,320,1.963190184,83,330,1.975903614,21,61,1.904761905,104,391,3.759615385,27,66,1.444444444,11,32,1.909090909,38,98,2.578947368,4,3,0.75
POA5214,1378,2711,1.967343977,405,1627,2.017283951,149,476,2.194630872,554,2103,3.796028881,179,509,1.843575419,136,277,1.036764706,315,786,2.495238095,22,50,2.272727273
POA5220,12,28,2.333333333,10,44,2.4,4,14,2.5,14,58,4.142857143,5,16,2.2,3,3,0,8,19,2.375,3,5,1.666666667
POA5221,37,67,1.810810811,9,46,3.111111111,4,7,0.75,13,53,4.076923077,3,9,2,3,9,2,6,18,3,0,0,#DIV/0!
POA5222,101,198,1.96039604,34,114,1.352941176,9,26,1.888888889,43,140,3.255813953,14,34,1.428571429,3,6,1,17,40,2.352941176,3,3,1
POA5223,477,936,1.962264151,285,1117,1.919298246,68,197,1.897058824,353,1314,3.722379603,62,167,1.693548387,27,52,0.925925926,89,219,2.460674157,7,10,1.428571429
POA5231,148,294,1.986486486,120,494,2.116666667,62,203,2.274193548,182,697,3.82967033,8,23,1.875,13,33,1.538461538,21,56,2.666666667,5,4,0.8
POA5232,59,117,1.983050847,46,193,2.195652174,22,77,2.5,68,270,3.970588235,9,32,2.555555556,6,9,0.5,15,41,2.733333333,3,3,1
POA5233,170,335,1.970588235,111,441,1.972972973,66,234,2.545454545,177,675,3.813559322,25,67,1.68,24,48,1,49,115,2.346938776,3,4,1.333333333
POA5234,155,313,2.019354839,129,532,2.124031008,53,176,2.320754717,182,708,3.89010989,28,82,1.928571429,15,34,1.266666667,43,116,2.697674419,0,4,#DIV/0!
POA5235,249,479,1.923694779,134,531,1.962686567,72,229,2.180555556,206,760,3.689320388,41,107,1.609756098,29,63,1.172413793,70,170,2.428571429,4,5,1.25
POA5236,75,144,1.92,51,216,2.235294118,18,59,2.277777778,69,275,3.985507246,9,26,1.888888889,9,15,0.666666667,18,41,2.277777778,3,4,1.333333333
POA5237,4,5,1.25,6,24,2,0,8,#DIV/0!,6,32,5.333333333,4,6,0.5,4,6,0.5,8,12,1.5,0,0,#DIV/0!
POA5238,570,1125,1.973684211,198,818,2.131313131,101,319,2.158415842,299,1137,3.802675585,83,242,1.915662651,71,156,1.197183099,154,398,2.584415584,11,24,2.181818182
POA5240,78,145,1.858974359,41,172,2.195121951,25,91,2.64,66,263,3.984848485,8,16,1,6,17,1.833333333,14,33,2.357142857,0,0,#DIV/0!
POA5241,263,526,2,210,867,2.128571429,81,272,2.358024691,291,1139,3.914089347,52,141,1.711538462,44,87,0.977272727,96,228,2.375,7,19,2.714285714
POA5242,134,264,1.970149254,101,410,2.059405941,38,123,2.236842105,139,533,3.834532374,21,55,1.619047619,22,43,0.954545455,43,98,2.279069767,0,3,#DIV/0!
POA5243,120,232,1.933333333,67,267,1.985074627,64,220,2.4375,131,487,3.717557252,17,45,1.647058824,11,24,1.181818182,28,69,2.464285714,3,6,2
POA5244,444,870,1.959459459,370,1498,2.048648649,163,544,2.337423313,533,2042,3.831144465,64,180,1.8125,57,118,1.070175439,121,298,2.462809917,5,14,2.8
POA5245,388,768,1.979381443,285,1159,2.066666667,148,503,2.398648649,433,1662,3.838337182,42,129,2.071428571,52,114,1.192307692,94,243,2.585106383,10,15,1.5
POA5250,309,600,1.941747573,348,1414,2.063218391,124,407,2.282258065,472,1821,3.858050847,64,176,1.75,46,105,1.282608696,110,281,2.554545455,0,7,#DIV/0!
POA5251,1339,2637,1.969380134,1137,4609,2.053649956,396,1350,2.409090909,1533,5959,3.88714938,365,993,1.720547945,264,584,1.212121212,629,1577,2.507154213,36,69,1.916666667
POA5252,572,1118,1.954545455,618,2549,2.124595469,200,658,2.29,818,3207,3.920537897,135,349,1.585185185,89,204,1.292134831,224,553,2.46875,14,27,1.928571429
POA5253,1980,3922,1.980808081,1230,5087,2.135772358,507,1688,2.32938856,1737,6775,3.900402994,535,1614,2.01682243,346,753,1.176300578,881,2367,2.686719637,76,155,2.039473684
POA5254,253,502,1.984189723,191,813,2.256544503,89,282,2.168539326,280,1095,3.910714286,45,141,2.133333333,31,70,1.258064516,76,211,2.776315789,8,15,1.875
POA5255,1121,2192,1.955396967,687,2889,2.205240175,281,919,2.270462633,968,3808,3.933884298,187,544,1.909090909,145,315,1.172413793,332,859,2.587349398,22,51,2.318181818
POA5256,182,362,1.989010989,60,272,2.533333333,28,86,2.071428571,88,358,4.068181818,27,73,1.703703704,19,33,0.736842105,46,106,2.304347826,3,4,1.333333333
POA5259,102,197,1.931372549,40,187,2.675,21,57,1.714285714,61,244,4,15,54,2.6,7,18,1.571428571,22,72,3.272727273,7,15,2.142857143
POA5260,227,444,1.955947137,120,487,2.058333333,48,163,2.395833333,168,650,3.869047619,49,135,1.755102041,42,93,1.214285714,91,228,2.505494505,9,17,1.888888889
POA5261,48,99,2.0625,37,166,2.486486486,14,51,2.642857143,51,217,4.254901961,0,3,#DIV/0!,0,0,#DIV/0!,0,3,#DIV/0!,0,0,#DIV/0!
POA5262,79,152,1.924050633,56,229,2.089285714,17,53,2.117647059,73,282,3.863013699,0,5,#DIV/0!,6,7,0.166666667,6,12,2,0,0,#DIV/0!
POA5263,43,83,1.930232558,34,139,2.088235294,10,38,2.8,44,177,4.022727273,3,3,0,3,5,0.666666667,6,8,1.333333333,0,0,#DIV/0!
POA5264,191,361,1.890052356,103,424,2.116504854,36,111,2.083333333,139,535,3.848920863,17,61,2.588235294,22,49,1.227272727,39,110,2.820512821,5,11,2.2
POA5265,98,193,1.969387755,84,338,2.023809524,17,62,2.647058824,101,400,3.96039604,9,27,2,12,25,1.083333333,21,52,2.476190476,3,3,1
POA5266,46,87,1.891304348,29,103,1.551724138,0,8,#DIV/0!,29,111,3.827586207,0,3,#DIV/0!,4,10,1.5,4,13,3.25,0,0,#DIV/0!
POA5267,250,493,1.972,213,889,2.17370892,51,155,2.039215686,264,1044,3.954545455,22,56,1.545454545,22,59,1.681818182,44,115,2.613636364,6,10,1.666666667
POA5268,383,751,1.960835509,261,1078,2.130268199,66,207,2.136363636,327,1285,3.929663609,75,217,1.893333333,33,69,1.090909091,108,286,2.648148148,10,23,2.3
POA5269,20,42,2.1,25,108,2.32,12,43,2.583333333,37,151,4.081081081,8,29,2.625,3,3,0,11,32,2.909090909,0,0,#DIV/0!
POA5270,113,233,2.061946903,93,410,2.408602151,33,102,2.090909091,126,512,4.063492063,16,45,1.8125,11,19,0.727272727,27,64,2.37037037,3,3,1
POA5271,875,1742,1.990857143,567,2242,1.954144621,177,539,2.04519774,744,2781,3.737903226,131,359,1.740458015,68,147,1.161764706,199,506,2.542713568,25,51,2.04
POA5272,127,244,1.921259843,97,386,1.979381443,39,111,1.846153846,136,497,3.654411765,12,35,1.916666667,8,18,1.25,20,53,2.65,3,4,1.333333333
POA5275,337,644,1.910979228,151,600,1.973509934,66,212,2.212121212,217,812,3.741935484,45,128,1.844444444,30,58,0.933333333,75,186,2.48,3,6,2
POA5276,215,416,1.934883721,104,426,2.096153846,24,79,2.291666667,128,505,3.9453125,16,35,1.1875,13,28,1.153846154,29,63,2.172413793,4,4,1
POA5277,306,598,1.954248366,222,884,1.981981982,69,221,2.202898551,291,1105,3.797250859,55,156,1.836363636,37,74,1,92,230,2.5,9,13,1.444444444
POA5278,60,118,1.966666667,38,162,2.263157895,15,38,1.533333333,53,200,3.773584906,18,47,1.611111111,7,24,2.428571429,25,71,2.84,0,0,#DIV/0!
POA5279,52,103,1.980769231,26,114,2.384615385,10,21,1.1,36,135,3.75,20,59,1.95,6,14,1.333333333,26,73,2.807692308,0,3,#DIV/0!
POA5280,948,1872,1.974683544,559,2341,2.18783542,227,713,2.140969163,786,3054,3.885496183,168,495,1.946428571,129,281,1.178294574,297,776,2.612794613,19,38,2
POA5290,2754,5417,1.966957153,1928,7861,2.077282158,630,2032,2.225396825,2558,9893,3.86747459,838,2383,1.843675418,506,1098,1.169960474,1344,3481,2.590029762,79,157,1.987341772
POA5291,1016,2007,1.975393701,832,3460,2.158653846,320,1030,2.21875,1152,4490,3.897569444,114,310,1.719298246,83,187,1.253012048,197,497,2.52284264,22,39,1.772727273
POA5301,67,131,1.955223881,43,185,2.302325581,14,39,1.785714286,57,224,3.929824561,12,33,1.75,6,12,1,18,45,2.5,0,0,#DIV/0!
POA5302,109,213,1.95412844,79,311,1.936708861,12,43,2.583333333,91,354,3.89010989,11,32,1.909090909,13,33,1.538461538,24,65,2.708333333,3,3,1
POA5303,42,82,1.952380952,37,172,2.648648649,12,39,2.25,49,211,4.306122449,4,9,1.25,5,12,1.4,9,21,2.333333333,4,0,0
POA5304,71,142,2,44,161,1.659090909,14,45,2.214285714,58,206,3.551724138,7,14,1,5,9,0.8,12,23,1.916666667,0,0,#DIV/0!
POA5307,86,167,1.941860465,44,186,2.227272727,16,51,2.1875,60,237,3.95,10,27,1.7,6,7,0.166666667,16,34,2.125,0,10,#DIV/0!
POA5308,31,52,1.677419355,19,74,1.894736842,7,28,3,26,102,3.923076923,0,7,#DIV/0!,6,9,0.5,6,16,2.666666667,0,3,#DIV/0!
POA5309,24,39,1.625,14,65,2.642857143,7,18,1.571428571,21,83,3.952380952,0,4,#DIV/0!,3,3,0,3,7,2.333333333,0,3,#DIV/0!
POA5311,69,140,2.028985507,55,236,2.290909091,19,64,2.368421053,74,300,4.054054054,3,19,5.333333333,11,14,0.272727273,14,33,2.357142857,5,7,1.4
POA5320,93,175,1.88172043,34,140,2.117647059,12,34,1.833333333,46,174,3.782608696,12,35,1.916666667,14,26,0.857142857,26,61,2.346153846,0,3,#DIV/0!
POA5321,36,64,1.777777778,17,72,2.235294118,13,35,1.692307692,30,107,3.566666667,0,0,#DIV/0!,0,6,#DIV/0!,0,6,#DIV/0!,3,3,1
POA5322,149,297,1.993288591,72,309,2.291666667,32,96,2,104,405,3.894230769,15,46,2.066666667,15,29,0.933333333,30,75,2.5,0,0,#DIV/0!
POA5330,399,791,1.98245614,227,942,2.149779736,85,287,2.376470588,312,1229,3.939102564,83,227,1.734939759,32,70,1.1875,115,297,2.582608696,10,21,2.1
POA5331,106,214,2.018867925,42,164,1.904761905,22,65,1.954545455,64,229,3.578125,12,45,2.75,9,13,0.444444444,21,58,2.761904762,0,0,#DIV/0!
POA5332,24,43,1.791666667,5,25,3,6,18,2,11,43,3.909090909,0,8,#DIV/0!,3,7,1.333333333,3,15,5,0,0,#DIV/0!
POA5333,750,1483,1.977333333,411,1701,2.138686131,168,567,2.375,579,2268,3.917098446,136,393,1.889705882,83,182,1.192771084,219,575,2.625570776,18,31,1.722222222
POA5340,189,371,1.962962963,106,428,2.037735849,34,111,2.264705882,140,539,3.85,26,76,1.923076923,13,29,1.230769231,39,105,2.692307692,6,12,2
POA5341,852,1679,1.970657277,532,2208,2.15037594,236,785,2.326271186,768,2993,3.897135417,202,616,2.04950495,133,284,1.135338346,335,900,2.686567164,29,63,2.172413793
POA5342,140,284,2.028571429,101,407,2.02970297,49,154,2.142857143,150,561,3.74,26,80,2.076923077,18,35,0.944444444,44,115,2.613636364,5,12,2.4
POA5343,599,1185,1.978297162,350,1423,2.065714286,109,349,2.201834862,459,1772,3.860566449,180,533,1.961111111,108,232,1.148148148,288,765,2.65625,20,44,2.2
POA5344,96,190,1.979166667,92,388,2.217391304,40,134,2.35,132,522,3.954545455,18,60,2.333333333,16,30,0.875,34,90,2.647058824,0,3,#DIV/0!
POA5345,447,898,2.008948546,208,860,2.134615385,105,336,2.2,313,1196,3.821086262,99,308,2.111111111,65,146,1.246153846,164,454,2.768292683,12,17,1.416666667
POA5346,51,102,2,41,164,2,15,42,1.8,56,206,3.678571429,9,19,1.111111111,9,12,0.333333333,18,31,1.722222222,3,8,2.666666667
POA5350,62,121,1.951612903,40,175,2.375,24,69,1.875,64,244,3.8125,6,15,1.5,3,10,2.333333333,9,25,2.777777778,0,0,#DIV/0!
POA5351,672,1314,1.955357143,578,2361,2.084775087,238,786,2.302521008,816,3147,3.856617647,90,274,2.044444444,55,123,1.236363636,145,397,2.737931034,11,24,2.181818182
POA5352,685,1340,1.95620438,415,1683,2.055421687,166,539,2.246987952,581,2222,3.82444062,77,217,1.818181818,64,140,1.1875,141,357,2.531914894,12,27,2.25
POA5353,505,987,1.954455446,334,1353,2.050898204,130,423,2.253846154,464,1776,3.827586207,75,203,1.706666667,55,124,1.254545455,130,327,2.515384615,9,17,1.888888889
POA5354,68,139,2.044117647,10,49,2.9,14,45,2.214285714,24,94,3.916666667,6,18,2,6,14,1.333333333,12,32,2.666666667,5,4,0.8
POA5355,923,1815,1.966413868,601,2476,2.119800333,241,773,2.20746888,842,3249,3.858669834,147,417,1.836734694,86,190,1.209302326,233,607,2.605150215,15,27,1.8
POA5356,82,161,1.963414634,51,218,2.274509804,28,96,2.428571429,79,314,3.974683544,15,37,1.466666667,8,20,1.5,23,57,2.47826087,0,3,#DIV/0!
POA5357,96,186,1.9375,42,175,2.166666667,24,70,1.916666667,66,245,3.712121212,10,30,2,3,9,2,13,39,3,0,0,#DIV/0!
POA5360,139,275,1.978417266,114,481,2.219298246,45,131,1.911111111,159,612,3.849056604,15,46,2.066666667,10,21,1.1,25,67,2.68,3,3,1
POA5371,108,210,1.944444444,146,623,2.267123288,65,210,2.230769231,211,833,3.947867299,33,107,2.242424242,18,45,1.5,51,152,2.980392157,4,7,1.75
POA5372,195,380,1.948717949,186,789,2.241935484,78,259,2.320512821,264,1048,3.96969697,40,124,2.1,28,67,1.392857143,68,191,2.808823529,3,8,2.666666667
POA5373,399,790,1.979949875,225,959,2.262222222,105,347,2.304761905,330,1306,3.957575758,67,192,1.865671642,67,147,1.194029851,134,339,2.529850746,12,22,1.833333333
POA5374,182,371,2.038461538,98,410,2.183673469,44,158,2.590909091,142,568,4,48,137,1.854166667,23,54,1.347826087,71,191,2.690140845,6,9,1.5
POA5381,45,88,1.955555556,24,99,2.125,5,22,3.4,29,121,4.172413793,6,14,1.333333333,7,17,1.428571429,13,31,2.384615385,0,3,#DIV/0!
POA5400,101,189,1.871287129,77,303,1.935064935,43,127,1.953488372,120,430,3.583333333,17,47,1.764705882,10,26,1.6,27,73,2.703703704,0,3,#DIV/0!
POA5401,86,168,1.953488372,73,302,2.136986301,34,110,2.235294118,107,412,3.85046729,24,60,1.5,9,20,1.222222222,33,80,2.424242424,3,6,2
POA5410,27,52,1.925925926,16,71,2.4375,10,23,1.3,26,94,3.615384615,8,17,1.125,3,8,1.666666667,11,25,2.272727273,0,3,#DIV/0!
POA5411,32,68,2.125,25,121,2.84,13,31,1.384615385,38,152,4,7,28,3,5,9,0.8,12,37,3.083333333,0,0,#DIV/0!
POA5412,180,352,1.955555556,75,294,1.92,27,93,2.444444444,102,387,3.794117647,35,101,1.885714286,14,33,1.357142857,49,134,2.734693878,0,3,#DIV/0!
POA5413,108,213,1.972222222,49,208,2.244897959,22,59,1.681818182,71,267,3.76056338,15,49,2.266666667,14,25,0.785714286,29,74,2.551724138,5,13,2.6
POA5414,31,57,1.838709677,21,86,2.095238095,13,48,2.692307692,34,134,3.941176471,0,17,#DIV/0!,5,3,-0.4,5,20,4,0,0,#DIV/0!
POA5415,63,123,1.952380952,34,133,1.911764706,12,35,1.916666667,46,168,3.652173913,0,11,#DIV/0!,5,7,0.4,5,18,3.6,0,0,#DIV/0!
POA5416,25,49,1.96,12,58,2.833333333,4,13,2.25,16,71,4.4375,3,11,2.666666667,0,0,#DIV/0!,3,11,3.666666667,3,3,1
POA5417,229,452,1.973799127,129,520,2.031007752,58,175,2.017241379,187,695,3.71657754,35,97,1.771428571,21,57,1.714285714,56,154,2.75,9,12,1.333333333
POA5419,41,78,1.902439024,16,62,1.875,9,22,1.444444444,25,84,3.36,6,14,1.333333333,3,4,0.333333333,9,18,2,0,0,#DIV/0!
POA5421,27,56,2.074074074,14,74,3.285714286,9,18,1,23,92,4,3,4,0.333333333,3,7,1.333333333,6,11,1.833333333,0,0,#DIV/0!
POA5422,252,495,1.964285714,107,448,2.186915888,33,116,2.515151515,140,564,4.028571429,75,219,1.92,31,65,1.096774194,106,284,2.679245283,8,10,1.25
POA5431,131,253,1.93129771,49,203,2.142857143,33,96,1.909090909,82,299,3.646341463,9,21,1.333333333,18,36,1,27,57,2.111111111,4,7,1.75
POA5433,207,398,1.922705314,105,432,2.114285714,32,101,2.15625,137,533,3.890510949,38,108,1.842105263,26,53,1.038461538,64,161,2.515625,0,3,#DIV/0!
POA5434,36,68,1.888888889,11,32,0.909090909,6,19,2.166666667,17,51,3,6,21,2.5,6,11,0.833333333,12,32,2.666666667,3,6,2
POA5440,63,117,1.857142857,32,107,1.34375,8,23,1.875,40,130,3.25,3,13,3.333333333,0,0,#DIV/0!,3,13,4.333333333,0,0,#DIV/0!
POA5451,88,174,1.977272727,39,165,2.230769231,13,46,2.538461538,52,211,4.057692308,9,25,1.777777778,8,14,0.75,17,39,2.294117647,0,3,#DIV/0!
POA5452,74,148,2,47,191,2.063829787,5,21,3.2,52,212,4.076923077,6,19,2.166666667,3,7,1.333333333,9,26,2.888888889,0,0,#DIV/0!
POA5453,608,1184,1.947368421,372,1546,2.155913978,119,392,2.294117647,491,1938,3.947046843,79,224,1.835443038,42,99,1.357142857,121,323,2.669421488,11,25,2.272727273
POA5454,54,105,1.944444444,38,161,2.236842105,12,42,2.5,50,203,4.06,3,11,2.666666667,5,7,0.4,8,18,2.25,0,0,#DIV/0!
POA5460,76,149,1.960526316,60,241,2.016666667,13,39,2,73,280,3.835616438,20,69,2.45,6,18,2,26,87,3.346153846,4,4,1
POA5461,315,615,1.952380952,192,819,2.265625,75,251,2.346666667,267,1070,4.007490637,55,174,2.163636364,35,76,1.171428571,90,250,2.777777778,4,12,3
POA5462,39,80,2.051282051,34,145,2.264705882,5,24,3.8,39,169,4.333333333,14,34,1.428571429,6,8,0.333333333,20,42,2.1,0,4,#DIV/0!
POA5464,57,110,1.929824561,31,137,2.419354839,13,49,2.769230769,44,186,4.227272727,9,23,1.555555556,3,11,2.666666667,12,34,2.833333333,0,0,#DIV/0!
POA5470,30,66,2.2,18,70,1.888888889,8,20,1.5,26,90,3.461538462,3,12,3,3,3,0,6,15,2.5,0,0,#DIV/0!
POA5472,35,66,1.885714286,24,88,1.666666667,8,23,1.875,32,111,3.46875,7,22,2.142857143,0,3,#DIV/0!,7,25,3.571428571,0,3,#DIV/0!
POA5473,111,218,1.963963964,63,265,2.206349206,19,60,2.157894737,82,325,3.963414634,15,50,2.333333333,10,22,1.2,25,72,2.88,0,3,#DIV/0!
POA5480,122,238,1.950819672,58,240,2.137931034,20,67,2.35,78,307,3.935897436,9,16,0.777777778,13,32,1.461538462,22,48,2.181818182,3,3,1
POA5481,88,176,2,36,142,1.944444444,16,48,2,52,190,3.653846154,8,25,2.125,4,8,1,12,33,2.75,0,0,#DIV/0!
POA5482,73,143,1.95890411,45,202,2.488888889,16,46,1.875,61,248,4.06557377,3,6,1,3,3,0,6,9,1.5,0,3,#DIV/0!
POA5483,50,93,1.86,34,137,2.029411765,13,34,1.615384615,47,171,3.638297872,8,27,2.375,3,3,0,11,30,2.727272727,0,3,#DIV/0!
POA5485,128,245,1.9140625,51,228,2.470588235,25,73,1.92,76,301,3.960526316,11,43,2.909090909,7,14,1,18,57,3.166666667,3,3,1
POA5490,27,54,2,16,70,2.375,5,12,1.4,21,82,3.904761905,0,0,#DIV/0!,4,8,1,4,8,2,0,3,#DIV/0!
POA5491,242,475,1.962809917,127,506,1.984251969,42,125,1.976190476,169,631,3.733727811,30,79,1.633333333,26,58,1.230769231,56,137,2.446428571,5,10,2
POA5495,109,205,1.880733945,26,100,1.846153846,13,48,2.692307692,39,148,3.794871795,8,28,2.5,9,17,0.888888889,17,45,2.647058824,0,0,#DIV/0!
POA5501,695,1367,1.966906475,611,2518,2.12111293,305,1025,2.360655738,916,3543,3.86790393,120,352,1.933333333,115,272,1.365217391,235,624,2.655319149,16,34,2.125
POA5502,202,394,1.95049505,142,594,2.183098592,69,214,2.101449275,211,808,3.829383886,33,94,1.848484848,18,38,1.111111111,51,132,2.588235294,3,9,3
POA5510,44,82,1.863636364,29,132,2.551724138,17,46,1.705882353,46,178,3.869565217,6,15,1.5,8,12,0.5,14,27,1.928571429,0,3,#DIV/0!
POA5520,75,152,2.026666667,40,176,2.4,15,45,2,55,221,4.018181818,15,48,2.2,9,22,1.444444444,24,70,2.916666667,3,4,1.333333333
POA5521,51,101,1.980392157,32,140,2.375,11,30,1.727272727,43,170,3.953488372,5,17,2.4,4,7,0.75,9,24,2.666666667,0,3,#DIV/0!
POA5522,269,523,1.944237918,85,334,1.929411765,27,83,2.074074074,112,417,3.723214286,28,72,1.571428571,18,41,1.277777778,46,113,2.456521739,4,9,2.25
POA5523,257,501,1.949416342,114,507,2.447368421,46,157,2.413043478,160,664,4.15,25,79,2.16,28,62,1.214285714,53,141,2.660377358,4,11,2.75
POA5540,1706,3370,1.975381008,1100,4603,2.184545455,426,1372,2.220657277,1526,5975,3.915465269,502,1493,1.974103586,296,644,1.175675676,798,2137,2.677944862,51,102,2
POA5550,84,171,2.035714286,52,216,2.153846154,29,91,2.137931034,81,307,3.790123457,24,76,2.166666667,11,16,0.454545455,35,92,2.628571429,5,10,2
POA5552,7,11,1.571428571,6,21,1.5,3,11,2.666666667,9,32,3.555555556,4,12,2,0,0,#DIV/0!,4,12,3,0,0,#DIV/0!
POA5554,656,1286,1.960365854,427,1774,2.154566745,124,407,2.282258065,551,2181,3.958257713,138,414,2,94,216,1.29787234,232,630,2.715517241,11,26,2.363636364
POA5555,80,156,1.95,42,181,2.30952381,22,58,1.636363636,64,239,3.734375,4,12,2,3,9,2,7,21,3,0,0,#DIV/0!
POA5556,597,1181,1.978224456,200,805,2.025,87,278,2.195402299,287,1083,3.773519164,99,278,1.808080808,66,142,1.151515152,165,420,2.545454545,16,35,2.1875
POA5558,677,1343,1.983751846,220,881,2.004545455,101,324,2.207920792,321,1205,3.753894081,102,279,1.735294118,48,100,1.083333333,150,379,2.526666667,10,24,2.4
POA5560,53,113,2.132075472,34,142,2.176470588,7,14,1,41,156,3.804878049,12,31,1.583333333,7,15,1.142857143,19,46,2.421052632,0,0,#DIV/0!
POA5570,116,231,1.99137931,50,227,2.54,32,89,1.78125,82,316,3.853658537,14,38,1.714285714,15,25,0.666666667,29,63,2.172413793,0,0,#DIV/0!
POA5571,334,653,1.95508982,58,233,2.017241379,19,60,2.157894737,77,293,3.805194805,21,59,1.80952381,21,40,0.904761905,42,99,2.357142857,4,10,2.5
POA5572,40,78,1.95,48,197,2.104166667,8,32,3,56,229,4.089285714,3,9,2,3,4,0.333333333,6,13,2.166666667,0,0,#DIV/0!
POA5573,275,542,1.970909091,143,611,2.272727273,36,121,2.361111111,179,732,4.089385475,52,178,2.423076923,31,65,1.096774194,83,243,2.927710843,5,6,1.2
POA5575,492,965,1.961382114,192,796,2.145833333,74,226,2.054054054,266,1022,3.842105263,44,119,1.704545455,42,78,0.857142857,86,197,2.290697674,4,6,1.5
POA5576,141,273,1.936170213,55,220,2,21,50,1.380952381,76,270,3.552631579,13,50,2.846153846,10,19,0.9,23,69,3,0,7,#DIV/0!
POA5577,26,56,2.153846154,10,39,1.9,6,21,2.5,16,60,3.75,6,16,1.666666667,3,10,2.333333333,9,26,2.888888889,0,0,#DIV/0!
POA5580,69,138,2,37,158,2.27027027,13,45,2.461538462,50,203,4.06,8,19,1.375,3,6,1,11,25,2.272727273,0,0,#DIV/0!
POA5581,103,202,1.961165049,15,50,1.333333333,8,26,2.25,23,76,3.304347826,6,6,0,3,12,3,9,18,2,3,3,1
POA5582,95,189,1.989473684,23,94,2.086956522,10,31,2.1,33,125,3.787878788,10,31,2.1,8,16,1,18,47,2.611111111,0,0,#DIV/0!
POA5583,136,261,1.919117647,32,137,2.28125,11,38,2.454545455,43,175,4.069767442,10,32,2.2,8,14,0.75,18,46,2.555555556,3,6,2
POA5600,792,1552,1.95959596,589,2391,2.05942275,241,766,2.178423237,830,3157,3.803614458,112,295,1.633928571,86,190,1.209302326,198,485,2.449494949,34,64,1.882352941
POA5601,23,49,2.130434783,5,23,2.6,0,0,#DIV/0!,5,23,4.6,0,0,#DIV/0!,3,3,0,3,3,1,3,7,2.333333333
POA5602,148,299,2.02027027,76,309,2.065789474,29,78,1.689655172,105,387,3.685714286,15,46,2.066666667,9,16,0.777777778,24,62,2.583333333,3,4,1.333333333
POA5603,29,59,2.034482759,16,56,1.5,3,15,4,19,71,3.736842105,7,16,1.285714286,4,7,0.75,11,23,2.090909091,0,0,#DIV/0!
POA5604,34,56,1.647058824,3,15,3,0,0,#DIV/0!,3,15,5,0,3,#DIV/0!,0,4,#DIV/0!,0,7,#DIV/0!,0,0,#DIV/0!
POA5605,281,553,1.96797153,126,526,2.174603175,38,118,2.105263158,164,644,3.926829268,32,90,1.8125,17,33,0.941176471,49,123,2.510204082,5,11,2.2
POA5606,1554,3029,1.949163449,1111,4447,2.00270027,327,1020,2.119266055,1438,5467,3.801808067,415,1229,1.961445783,284,606,1.133802817,699,1835,2.625178827,52,105,2.019230769
POA5607,561,1090,1.942959002,419,1722,2.109785203,147,458,2.115646259,566,2180,3.851590106,68,187,1.75,41,83,1.024390244,109,270,2.47706422,8,21,2.625
POA5608,1374,2718,1.978165939,902,3623,2.016629712,316,996,2.151898734,1218,4619,3.79228243,627,1827,1.913875598,346,751,1.170520231,973,2578,2.649537513,51,104,2.039215686
POA5609,168,329,1.958333333,159,623,1.918238994,52,161,2.096153846,211,784,3.71563981,25,72,1.88,7,22,2.142857143,32,94,2.9375,4,5,1.25
POA5630,27,56,2.074074074,18,90,3,11,18,0.636363636,29,108,3.724137931,3,8,1.666666667,3,6,1,6,14,2.333333333,0,0,#DIV/0!
POA5631,122,238,1.950819672,111,455,2.099099099,15,49,2.266666667,126,504,4,20,65,2.25,11,21,0.909090909,31,86,2.774193548,0,7,#DIV/0!
POA5633,45,91,2.022222222,45,180,2,16,44,1.75,61,224,3.672131148,9,19,1.111111111,0,6,#DIV/0!,9,25,2.777777778,0,3,#DIV/0!
POA5640,144,282,1.958333333,66,276,2.181818182,20,61,2.05,86,337,3.918604651,11,38,2.454545455,13,31,1.384615385,24,69,2.875,3,3,1
POA5641,150,300,2,110,440,2,27,74,1.740740741,137,514,3.751824818,7,22,2.142857143,8,19,1.375,15,41,2.733333333,0,0,#DIV/0!
POA5642,54,103,1.907407407,68,305,2.485294118,14,36,1.571428571,82,341,4.158536585,0,0,#DIV/0!,6,12,1,6,12,2,3,0,0
POA5650,29,58,2,34,144,2.235294118,7,21,2,41,165,4.024390244,6,6,0,4,9,1.25,10,15,1.5,3,3,1
POA5652,69,131,1.898550725,54,209,1.87037037,9,30,2.333333333,63,239,3.793650794,4,12,2,3,8,1.666666667,7,20,2.857142857,0,4,#DIV/0!
POA5654,35,71,2.028571429,40,160,2,6,30,4,46,190,4.130434783,6,13,1.166666667,3,10,2.333333333,9,23,2.555555556,0,3,#DIV/0!
POA5670,32,64,2,26,94,1.615384615,3,7,1.333333333,29,101,3.482758621,7,12,0.714285714,6,14,1.333333333,13,26,2,0,0,#DIV/0!
POA5680,290,558,1.924137931,183,740,2.043715847,60,191,2.183333333,243,931,3.83127572,27,85,2.148148148,30,65,1.166666667,57,150,2.631578947,6,10,1.666666667
POA5690,421,826,1.961995249,329,1437,2.367781155,60,180,2,389,1617,4.156812339,104,334,2.211538462,51,131,1.568627451,155,465,3,17,39,2.294117647
POA5700,1112,2160,1.942446043,762,3065,2.022309711,298,953,2.197986577,1060,4018,3.790566038,388,1195,2.079896907,221,487,1.20361991,609,1682,2.761904762,53,130,2.452830189
POA5710,321,616,1.919003115,209,802,1.837320574,96,278,1.895833333,305,1080,3.540983607,51,143,1.803921569,33,76,1.303030303,84,219,2.607142857,4,15,3.75
POA5720,19,38,2,7,27,1.857142857,5,17,2.4,12,44,3.666666667,10,19,0.9,3,8,1.666666667,13,27,2.076923077,0,0,#DIV/0!
POA5722,54,111,2.055555556,42,163,1.880952381,9,28,2.111111111,51,191,3.745098039,15,38,1.533333333,8,16,1,23,54,2.347826087,0,0,#DIV/0!
POA5723,181,349,1.928176796,95,379,1.989473684,30,103,2.433333333,125,482,3.856,33,103,2.121212121,13,32,1.461538462,46,135,2.934782609,11,23,2.090909091
POA5724,46,114,2.47826087,62,284,2.580645161,6,25,3.166666667,68,309,4.544117647,30,103,2.433333333,13,42,2.230769231,43,145,3.372093023,4,8,2
POA5725,361,704,1.950138504,530,2079,1.922641509,78,253,2.243589744,608,2332,3.835526316,27,76,1.814814815,31,66,1.129032258,58,142,2.448275862,12,20,1.666666667
POA5731,98,189,1.928571429,79,319,2.037974684,15,43,1.866666667,94,362,3.85106383,12,39,2.25,5,9,0.8,17,48,2.823529412,3,4,1.333333333
POA5732,5,13,2.6,10,33,1.3,5,18,2.6,15,51,3.4,15,41,1.733333333,0,5,#DIV/0!,15,46,3.066666667,0,0,#DIV/0!
POA5734,5,11,2.2,17,60,1.529411765,0,9,#DIV/0!,17,69,4.058823529,7,26,2.714285714,6,9,0.5,13,35,2.692307692,0,3,#DIV/0!
POA5950,0,0,#DIV/0!,0,0,#DIV/0!,0,0,#DIV/0!,0,0,#DIV/0!,0,0,#DIV/0!,0,0,#DIV/0!,0,0,#DIV/0!,0,0,#DIV/0!
POA5960,0,3,#DIV/0!,0,0,#DIV/0!,0,0,#DIV/0!,0,0,#DIV/0!,0,0,#DIV/0!,0,0,#DIV/0!,0,0,#DIV/0!,0,0,#DIV/0!
POA6000,1220,2350,1.926229508,281,966,1.43772242,80,254,2.175,361,1220,3.379501385,61,156,1.557377049,76,150,0.973684211,137,306,2.233576642,74,159,2.148648649
POA6003,393,765,1.946564885,85,293,1.447058824,41,133,2.243902439,126,426,3.380952381,33,82,1.484848485,31,57,0.838709677,64,139,2.171875,30,60,2
POA6004,1200,2299,1.915833333,244,846,1.467213115,128,372,1.90625,372,1218,3.274193548,40,91,1.275,92,191,1.076086957,132,282,2.136363636,88,183,2.079545455
POA6005,711,1366,1.921237693,141,481,1.411347518,47,153,2.255319149,188,634,3.372340426,32,73,1.28125,46,93,1.02173913,78,166,2.128205128,39,87,2.230769231
POA6006,891,1744,1.957351291,697,2639,1.786226686,227,762,2.356828194,924,3401,3.680735931,92,227,1.467391304,155,334,1.15483871,247,561,2.271255061,44,99,2.25
POA6007,822,1578,1.919708029,411,1573,1.827250608,145,469,2.234482759,556,2042,3.672661871,70,179,1.557142857,105,246,1.342857143,175,425,2.428571429,56,111,1.982142857
POA6008,1536,2952,1.921875,1007,3824,1.797418073,388,1295,2.337628866,1395,5119,3.66953405,147,397,1.700680272,239,515,1.154811715,386,912,2.362694301,60,119,1.983333333
POA6009,1513,2953,1.951751487,1402,5755,2.104850214,771,2633,2.415045396,2173,8388,3.860101243,145,398,1.744827586,249,573,1.301204819,394,971,2.464467005,130,271,2.084615385
POA6010,1521,2929,1.925706772,1203,4883,2.059019119,627,2125,2.389154705,1830,7008,3.829508197,191,528,1.764397906,315,717,1.276190476,506,1245,2.460474308,93,201,2.161290323
POA6011,892,1726,1.934977578,676,2787,2.122781065,361,1192,2.301939058,1037,3979,3.837029894,93,249,1.677419355,129,292,1.263565891,222,541,2.436936937,52,107,2.057692308
POA6012,819,1577,1.925518926,635,2544,2.006299213,285,982,2.445614035,920,3526,3.832608696,112,325,1.901785714,168,394,1.345238095,280,719,2.567857143,39,80,2.051282051
POA6014,1743,3415,1.959265634,1806,7311,2.048172757,667,2296,2.442278861,2473,9607,3.884755358,213,563,1.643192488,256,577,1.25390625,469,1140,2.430703625,101,196,1.940594059
POA6015,650,1263,1.943076923,572,2444,2.272727273,376,1306,2.473404255,948,3750,3.955696203,50,148,1.96,72,173,1.402777778,122,321,2.631147541,13,27,2.076923077
POA6016,845,1633,1.932544379,884,3359,1.799773756,222,754,2.396396396,1106,4113,3.71880651,146,377,1.582191781,162,351,1.166666667,308,728,2.363636364,68,141,2.073529412
POA6017,426,826,1.938967136,210,770,1.666666667,56,174,2.107142857,266,944,3.54887218,74,174,1.351351351,70,163,1.328571429,144,337,2.340277778,35,79,2.257142857
POA6018,3627,7088,1.954232148,2966,11627,1.920094403,1155,3870,2.350649351,4121,15497,3.760495025,541,1485,1.744916821,705,1534,1.175886525,1246,3019,2.422953451,200,430,2.15
POA6019,2356,4553,1.932512733,1336,5093,1.812125749,546,1817,2.327838828,1882,6910,3.67162593,327,813,1.486238532,370,800,1.162162162,697,1613,2.31420373,117,246,2.102564103
POA6020,2248,4397,1.955960854,1716,6913,2.028554779,1145,3824,2.339737991,2861,10737,3.752883607,260,684,1.630769231,354,813,1.296610169,614,1497,2.438110749,77,161,2.090909091
POA6021,2128,4213,1.979793233,1501,5923,1.946035976,829,2832,2.416164053,2330,8755,3.75751073,301,869,1.887043189,398,913,1.293969849,699,1782,2.549356223,131,286,2.183206107
POA6022,636,1265,1.988993711,402,1608,2,198,662,2.343434343,600,2270,3.783333333,108,288,1.666666667,123,280,1.276422764,231,568,2.458874459,22,42,1.909090909
POA6023,1601,3147,1.965646471,1453,5774,1.973847213,853,2876,2.371629543,2306,8650,3.751084128,191,552,1.890052356,274,627,1.288321168,465,1179,2.535483871,43,90,2.093023256
POA6024,1558,3068,1.969191271,1154,4568,1.958405546,614,2016,2.283387622,1768,6584,3.7239819,232,648,1.793103448,293,659,1.249146758,525,1307,2.48952381,68,139,2.044117647
POA6025,3146,6162,1.958677686,2663,10526,1.952684942,1456,4891,2.359203297,4119,15417,3.742898762,541,1494,1.76155268,585,1305,1.230769231,1126,2799,2.485790409,120,259,2.158333333
POA6026,2170,4249,1.958064516,2035,8240,2.049140049,1398,4739,2.389842632,3433,12979,3.780658316,313,880,1.811501597,425,977,1.298823529,738,1857,2.516260163,56,119,2.125
POA6027,4249,8265,1.945163568,3527,14176,2.019279841,2163,7230,2.34257975,5690,21406,3.762038664,792,2254,1.845959596,875,1988,1.272,1667,4242,2.544691062,195,415,2.128205128
POA6028,1515,2960,1.95379538,2304,9349,2.057725694,1205,4136,2.432365145,3509,13485,3.842975207,332,940,1.831325301,282,653,1.315602837,614,1593,2.594462541,52,109,2.096153846
POA6029,286,553,1.933566434,260,1030,1.961538462,124,401,2.233870968,384,1431,3.7265625,28,76,1.714285714,29,59,1.034482759,57,135,2.368421053,5,16,3.2
POA6030,3355,6537,1.948435171,3801,15365,2.042357274,1278,4317,2.377934272,5079,19682,3.875172278,1017,3030,1.979351032,582,1310,1.250859107,1599,4340,2.714196373,93,212,2.279569892
POA6031,849,1664,1.959952886,1393,5617,2.032304379,368,1256,2.413043478,1761,6873,3.902896082,345,1028,1.979710145,148,335,1.263513514,493,1363,2.764705882,33,62,1.878787879
POA6032,14,40,2.857142857,16,77,2.8125,11,39,2.545454545,27,116,4.296296296,6,8,0.333333333,3,6,1,9,14,1.555555556,0,0,#DIV/0!
POA6033,65,133,2.046153846,69,302,2.376811594,29,99,2.413793103,98,401,4.091836735,17,46,1.705882353,9,20,1.222222222,26,66,2.538461538,4,4,1
POA6035,452,879,1.944690265,391,1562,1.99488491,120,364,2.033333333,511,1926,3.769080235,108,308,1.851851852,67,140,1.089552239,175,448,2.56,6,16,2.666666667
POA6036,820,1602,1.953658537,1411,5702,2.041105599,246,840,2.414634146,1657,6542,3.948098974,323,976,2.021671827,119,273,1.294117647,442,1249,2.825791855,31,61,1.967741935
POA6037,274,526,1.919708029,174,696,2,64,197,2.078125,238,893,3.75210084,71,201,1.830985915,38,80,1.105263158,109,281,2.577981651,4,6,1.5
POA6041,228,440,1.929824561,93,399,2.290322581,35,107,2.057142857,128,506,3.953125,26,85,2.269230769,10,17,0.7,36,102,2.833333333,0,4,#DIV/0!
POA6042,16,26,1.625,3,7,0.333333333,0,0,#DIV/0!,3,7,2.333333333,0,4,#DIV/0!,0,0,#DIV/0!,0,4,#DIV/0!,0,0,#DIV/0!
POA6043,37,74,2,12,44,1.666666667,4,5,0.25,16,49,3.0625,3,10,2.333333333,3,4,0.333333333,6,14,2.333333333,0,0,#DIV/0!
POA6044,201,391,1.945273632,80,320,2,19,55,1.894736842,99,375,3.787878788,18,53,1.944444444,11,25,1.272727273,29,78,2.689655172,4,10,2.5
POA6050,1565,3048,1.947603834,994,3977,2.001006036,529,1846,2.489603025,1523,5823,3.823374918,146,378,1.589041096,206,461,1.237864078,352,839,2.383522727,93,205,2.204301075
POA6051,1466,2852,1.945429741,750,2706,1.608,183,597,2.262295082,933,3303,3.540192926,187,454,1.427807487,212,443,1.089622642,399,897,2.248120301,84,173,2.05952381
POA6052,1044,2047,1.960727969,832,3227,1.878605769,359,1205,2.356545961,1191,4432,3.721242653,204,586,1.87254902,226,507,1.243362832,430,1093,2.541860465,59,131,2.220338983
POA6053,1452,2823,1.944214876,1073,4088,1.809878844,385,1263,2.280519481,1458,5351,3.670096022,248,634,1.556451613,290,641,1.210344828,538,1275,2.369888476,95,196,2.063157895
POA6054,1976,3900,1.973684211,1502,6002,1.996005326,644,2148,2.335403727,2146,8150,3.797763281,564,1598,1.833333333,515,1150,1.233009709,1079,2748,2.546802595,133,286,2.15037594
POA6055,1175,2307,1.963404255,1058,4188,1.958412098,465,1538,2.307526882,1523,5726,3.759684833,224,669,1.986607143,209,475,1.272727273,433,1144,2.642032333,45,98,2.177777778
POA6056,3660,7197,1.966393443,2742,11132,2.059810357,1371,4541,2.31218089,4113,15673,3.810600535,987,2931,1.969604863,912,2016,1.210526316,1899,4947,2.605055292,179,372,2.078212291
POA6057,1693,3326,1.964559953,1369,5617,2.102994887,670,2274,2.394029851,2039,7891,3.870034331,350,1008,1.88,328,742,1.262195122,678,1750,2.581120944,57,121,2.122807018
POA6058,1275,2511,1.969411765,889,3560,2.004499438,459,1493,2.252723312,1348,5053,3.74851632,341,1005,1.947214076,267,609,1.280898876,608,1614,2.654605263,48,100,2.083333333
POA6059,2309,4547,1.969250758,1814,7241,1.991730981,999,3443,2.446446446,2813,10684,3.798080341,349,948,1.716332378,486,1103,1.269547325,835,2051,2.456287425,118,255,2.161016949
POA6060,2605,5176,1.986948177,1344,5057,1.76264881,438,1449,2.308219178,1782,6506,3.650953984,403,991,1.459057072,460,1009,1.193478261,863,2000,2.317497103,180,390,2.166666667
POA6061,2945,5885,1.998302207,2505,10630,2.243512974,837,2866,2.424133811,3342,13496,4.038300419,1010,3185,2.153465347,879,2040,1.320819113,1889,5225,2.766013764,258,561,2.174418605
POA6062,3404,6788,1.994124559,2361,9551,2.04531978,1437,4936,2.43493389,3798,14487,3.814375987,608,1734,1.851973684,740,1692,1.286486486,1348,3426,2.541543027,173,363,2.098265896
POA6063,1049,2092,1.994280267,1341,5557,2.143922446,612,2122,2.467320261,1953,7679,3.931899642,384,1173,2.0546875,322,728,1.260869565,706,1901,2.692634561,82,179,2.182926829
POA6064,2420,4852,2.004958678,2517,10700,2.251092571,1303,4479,2.437452034,3820,15179,3.973560209,885,2872,2.24519774,798,1855,1.324561404,1683,4727,2.808674985,191,433,2.267015707
POA6065,4837,9513,1.966714906,5961,24020,2.029525247,1926,6599,2.426272066,7887,30619,3.882211234,979,2836,1.896833504,669,1538,1.298953662,1648,4374,2.654126214,177,382,2.15819209
POA6066,1415,2817,1.990812721,1777,7516,2.22960045,1019,3595,2.527968597,2796,11111,3.973891273,479,1517,2.167014614,397,967,1.435768262,876,2484,2.835616438,74,161,2.175675676
POA6067,8,11,1.375,4,17,2.25,0,6,#DIV/0!,4,23,5.75,5,21,3.2,4,12,2,9,33,3.666666667,0,4,#DIV/0!
POA6068,0,0,#DIV/0!,0,0,#DIV/0!,0,0,#DIV/0!,0,0,#DIV/0!,0,0,#DIV/0!,0,0,#DIV/0!,0,0,#DIV/0!,0,0,#DIV/0!
POA6069,2323,4511,1.941885493,3093,12394,2.007112835,720,2369,2.290277778,3813,14763,3.871754524,626,1887,2.014376997,306,686,1.241830065,932,2573,2.760729614,57,115,2.01754386
POA6070,432,839,1.94212963,324,1330,2.104938272,172,553,2.215116279,496,1883,3.796370968,64,183,1.859375,53,118,1.226415094,117,301,2.572649573,11,21,1.909090909
POA6071,398,787,1.977386935,300,1230,2.1,172,560,2.255813953,472,1790,3.792372881,59,157,1.661016949,73,162,1.219178082,132,319,2.416666667,5,13,2.6
POA6072,102,205,2.009803922,69,289,2.188405797,43,131,2.046511628,112,420,3.75,8,25,2.125,22,45,1.045454545,30,70,2.333333333,0,0,#DIV/0!
POA6073,386,759,1.966321244,235,959,2.080851064,127,419,2.299212598,362,1378,3.806629834,43,145,2.372093023,52,109,1.096153846,95,254,2.673684211,12,20,1.666666667
POA6074,130,250,1.923076923,86,339,1.941860465,38,124,2.263157895,124,463,3.733870968,16,50,2.125,17,43,1.529411765,33,93,2.818181818,0,0,#DIV/0!
POA6076,2658,5202,1.957110609,1765,7172,2.063456091,1044,3497,2.349616858,2809,10669,3.798148807,311,895,1.877813505,376,842,1.239361702,687,1737,2.528384279,48,110,2.291666667
POA6077,184,362,1.967391304,109,475,2.357798165,99,326,2.292929293,208,801,3.850961538,15,50,2.333333333,22,47,1.136363636,37,97,2.621621622,5,12,2.4
POA6078,81,161,1.987654321,78,338,2.333333333,60,208,2.466666667,138,546,3.956521739,8,26,2.25,9,18,1,17,44,2.588235294,5,8,1.6
POA6079,0,0,#DIV/0!,0,0,#DIV/0!,0,0,#DIV/0!,0,0,#DIV/0!,0,0,#DIV/0!,0,0,#DIV/0!,0,0,#DIV/0!,0,0,#DIV/0!
POA6081,490,946,1.930612245,506,2072,2.09486166,198,650,2.282828283,704,2722,3.866477273,83,223,1.686746988,70,163,1.328571429,153,386,2.522875817,6,15,2.5
POA6082,341,659,1.93255132,291,1200,2.12371134,128,419,2.2734375,419,1619,3.863961814,69,206,1.985507246,55,128,1.327272727,124,334,2.693548387,4,13,3.25
POA6083,438,839,1.915525114,304,1251,2.115131579,172,552,2.209302326,476,1803,3.787815126,39,110,1.820512821,31,73,1.35483871,70,183,2.614285714,4,17,4.25
POA6084,741,1428,1.927125506,620,2529,2.079032258,264,833,2.15530303,884,3362,3.803167421,137,401,1.927007299,62,143,1.306451613,199,544,2.733668342,11,28,2.545454545
POA6090,0,0,#DIV/0!,0,0,#DIV/0!,0,0,#DIV/0!,0,0,#DIV/0!,0,0,#DIV/0!,0,0,#DIV/0!,0,0,#DIV/0!,0,0,#DIV/0!
POA6100,1670,3272,1.959281437,861,3144,1.651567944,303,992,2.273927393,1164,4136,3.553264605,163,398,1.441717791,208,443,1.129807692,371,841,2.266846361,153,328,2.14379085
POA6101,1593,3137,1.969240427,1056,4019,1.805871212,296,955,2.226351351,1352,4974,3.678994083,278,767,1.758992806,294,648,1.204081633,572,1415,2.473776224,174,361,2.074712644
POA6102,1082,2172,2.007393715,645,2547,1.948837209,198,641,2.237373737,843,3188,3.78173191,197,570,1.893401015,212,468,1.20754717,409,1038,2.537897311,205,443,2.16097561
POA6103,869,1717,1.975834292,535,2039,1.811214953,162,532,2.283950617,697,2571,3.68866571,152,447,1.940789474,181,385,1.127071823,333,832,2.498498498,96,205,2.135416667
POA6104,1364,2681,1.965542522,908,3533,1.890969163,350,1164,2.325714286,1258,4697,3.733704293,296,861,1.908783784,273,598,1.19047619,569,1459,2.564147627,102,216,2.117647059
POA6105,1348,2688,1.994065282,1024,4095,1.999023438,380,1241,2.265789474,1404,5336,3.800569801,336,1002,1.982142857,336,763,1.270833333,672,1765,2.626488095,102,212,2.078431373
POA6106,0,0,#DIV/0!,4,5,-0.75,0,0,#DIV/0!,4,5,1.25,0,0,#DIV/0!,0,0,#DIV/0!,0,0,#DIV/0!,0,0,#DIV/0!
POA6107,3443,6886,2,2964,12040,2.062078273,1121,3810,2.398751115,4085,15850,3.88004896,738,2205,1.987804878,727,1655,1.27647868,1465,3860,2.634812287,369,817,2.214092141
POA6108,2287,4559,1.993441189,1941,8078,2.161772282,1102,3681,2.340290381,3043,11759,3.864278672,495,1471,1.971717172,474,1108,1.337552743,969,2579,2.661506708,124,267,2.153225806
POA6109,994,1979,1.990945674,788,3278,2.159898477,349,1146,2.283667622,1137,4424,3.890941073,290,905,2.120689655,270,603,1.233333333,560,1508,2.692857143,56,117,2.089285714
POA6110,3198,6300,1.969981238,3052,12377,2.055373526,1204,4070,2.380398671,4256,16447,3.864426692,987,2942,1.980749747,715,1619,1.264335664,1702,4561,2.679788484,163,351,2.153374233
POA6111,2348,4642,1.977001704,1710,6996,2.09122807,945,3107,2.287830688,2655,10103,3.80527307,565,1628,1.881415929,496,1126,1.27016129,1061,2754,2.595664467,95,194,2.042105263
POA6112,3913,7715,1.971633018,3490,14371,2.117765043,1327,4423,2.33308214,4817,18794,3.901598505,1169,3515,2.006843456,838,1898,1.264916468,2007,5413,2.697060289,170,350,2.058823529
POA6121,275,544,1.978181818,278,1182,2.251798561,147,475,2.231292517,425,1657,3.898823529,44,128,1.909090909,22,48,1.181818182,66,176,2.666666667,9,12,1.333333333
POA6122,921,1800,1.954397394,1001,4180,2.175824176,357,1195,2.347338936,1358,5375,3.95802651,201,610,2.034825871,113,258,1.283185841,314,868,2.76433121,26,54,2.076923077
POA6123,140,277,1.978571429,149,637,2.275167785,57,166,1.912280702,206,803,3.898058252,36,100,1.777777778,32,69,1.15625,68,169,2.485294118,3,9,3
POA6124,124,237,1.911290323,97,392,2.041237113,38,117,2.078947368,135,509,3.77037037,25,74,1.96,11,27,1.454545455,36,101,2.805555556,6,9,1.5
POA6125,345,675,1.956521739,253,1058,2.181818182,115,361,2.139130435,368,1419,3.855978261,41,105,1.56097561,26,59,1.269230769,67,164,2.447761194,3,8,2.666666667
POA6126,40,84,2.1,13,59,2.538461538,9,29,2.222222222,22,88,4,5,21,3.2,3,6,1,8,27,3.375,5,3,0.6
POA6147,1373,2748,2.001456664,1186,4835,2.076728499,630,2165,2.436507937,1816,7000,3.854625551,353,1040,1.946175637,423,970,1.293144208,776,2010,2.590206186,118,254,2.152542373
POA6148,1714,3366,1.963827305,1455,5935,2.079037801,804,2737,2.404228856,2259,8672,3.838866755,268,741,1.764925373,354,786,1.220338983,622,1527,2.454983923,108,228,2.111111111
POA6149,1789,3536,1.976523197,1538,6189,2.024057217,1306,4481,2.431087289,2844,10670,3.751758087,209,605,1.894736842,373,861,1.308310992,582,1466,2.518900344,84,183,2.178571429
POA6150,1183,2363,1.997464074,1000,4170,2.17,900,3179,2.532222222,1900,7349,3.867894737,116,338,1.913793103,207,519,1.507246377,323,857,2.653250774,90,207,2.3
POA6151,1904,3687,1.93644958,1166,4474,1.837049743,473,1572,2.32346723,1639,6046,3.688834655,194,545,1.809278351,246,539,1.191056911,440,1084,2.463636364,143,297,2.076923077
POA6152,2556,4988,1.951486698,1494,5785,1.872155288,750,2545,2.393333333,2244,8330,3.712121212,367,1020,1.779291553,478,1065,1.228033473,845,2085,2.467455621,321,687,2.140186916
POA6153,2158,4228,1.959221501,1431,5631,1.935010482,907,3099,2.416758545,2338,8730,3.73396065,268,740,1.76119403,360,801,1.225,628,1541,2.453821656,139,310,2.230215827
POA6154,996,1956,1.963855422,814,3262,2.007371007,412,1360,2.300970874,1226,4622,3.769983687,138,361,1.615942029,190,426,1.242105263,328,787,2.399390244,51,118,2.31372549
POA6155,3930,7805,1.986005089,4964,20188,2.066881547,2530,8845,2.496047431,7494,29033,3.874165999,703,2037,1.897581792,759,1846,1.432147563,1462,3883,2.655950752,237,525,2.215189873
POA6156,1583,3101,1.958938724,1413,5636,1.988676575,566,1918,2.38869258,1979,7554,3.817079333,292,841,1.880136986,353,778,1.203966006,645,1619,2.510077519,63,135,2.142857143
POA6157,1450,2826,1.948965517,990,3779,1.817171717,374,1225,2.27540107,1364,5004,3.668621701,273,688,1.52014652,291,619,1.127147766,564,1307,2.317375887,62,135,2.177419355
POA6158,696,1356,1.948275862,614,2432,1.960912052,269,909,2.379182156,883,3341,3.783691959,96,261,1.71875,116,243,1.094827586,212,504,2.377358491,20,48,2.4
POA6159,356,691,1.941011236,166,591,1.560240964,52,163,2.134615385,218,754,3.458715596,40,102,1.55,52,109,1.096153846,92,211,2.293478261,5,14,2.8
POA6160,942,1803,1.914012739,375,1418,1.781333333,177,556,2.141242938,552,1974,3.576086957,98,265,1.704081633,163,338,1.073619632,261,603,2.310344828,46,101,2.195652174
POA6161,11,22,2,8,24,1,0,4,#DIV/0!,8,28,3.5,0,3,#DIV/0!,0,0,#DIV/0!,0,3,#DIV/0!,0,0,#DIV/0!
POA6162,1112,2157,1.939748201,756,2929,1.874338624,334,1078,2.22754491,1090,4007,3.676146789,238,640,1.68907563,245,535,1.183673469,483,1175,2.432712215,49,100,2.040816327
POA6163,4868,9563,1.964461791,3350,13275,1.962686567,1895,6314,2.331926121,5245,19589,3.734795043,1103,3086,1.797824116,1164,2606,1.238831615,2267,5692,2.510807234,271,570,2.103321033
POA6164,4246,8336,1.963259538,5267,20757,1.940953104,1715,5757,2.356851312,6982,26514,3.797479232,1010,2978,1.948514851,724,1619,1.236187845,1734,4597,2.651095732,237,497,2.097046414
POA6165,13,21,1.615384615,9,28,1.111111111,0,6,#DIV/0!,9,34,3.777777778,4,8,1,3,11,2.666666667,7,19,2.714285714,0,0,#DIV/0!
POA6166,882,1736,1.968253968,702,2847,2.055555556,468,1571,2.356837607,1170,4418,3.776068376,117,310,1.64957265,142,316,1.225352113,259,626,2.416988417,29,61,2.103448276
POA6167,2056,4034,1.962062257,1897,7649,2.032156036,600,1957,2.261666667,2497,9606,3.84701642,720,2063,1.865277778,451,1010,1.239467849,1171,3073,2.624252775,105,211,2.00952381
POA6168,2811,5481,1.949839915,1456,5798,1.982142857,675,2145,2.177777778,2131,7943,3.727358048,638,1826,1.862068966,502,1100,1.19123506,1140,2926,2.566666667,111,229,2.063063063
POA6169,3648,7061,1.93558114,2785,11189,2.017594255,1244,4060,2.263665595,4029,15249,3.784810127,1033,3041,1.943852856,684,1516,1.216374269,1717,4557,2.654047758,109,228,2.091743119
POA6170,564,1098,1.946808511,679,2755,2.057437408,208,684,2.288461538,887,3439,3.877113867,188,545,1.89893617,114,252,1.210526316,302,797,2.639072848,26,59,2.269230769
POA6171,1558,3002,1.926829268,2003,8011,1.999500749,429,1415,2.298368298,2432,9426,3.875822368,294,850,1.891156463,129,292,1.263565891,423,1142,2.699763593,35,75,2.142857143
POA6172,1092,2108,1.93040293,1528,6229,2.076570681,523,1740,2.326959847,2051,7969,3.885421745,395,1204,2.048101266,170,407,1.394117647,565,1611,2.851327434,28,54,1.928571429
POA6173,699,1345,1.924177396,1485,5890,1.966329966,355,1208,2.402816901,1840,7098,3.857608696,198,607,2.065656566,84,191,1.273809524,282,798,2.829787234,23,48,2.086956522
POA6174,205,397,1.936585366,199,826,2.150753769,77,260,2.376623377,276,1086,3.934782609,56,171,2.053571429,35,70,1,91,241,2.648351648,12,21,1.75
POA6175,256,493,1.92578125,347,1414,2.074927954,103,349,2.388349515,450,1763,3.917777778,72,220,2.055555556,36,79,1.194444444,108,299,2.768518519,5,9,1.8
POA6176,78,156,2,68,293,2.308823529,42,135,2.214285714,110,428,3.890909091,9,20,1.222222222,7,18,1.571428571,16,38,2.375,0,3,#DIV/0!
POA6180,354,690,1.949152542,378,1477,1.907407407,114,361,2.166666667,492,1838,3.735772358,69,202,1.927536232,41,90,1.195121951,110,292,2.654545455,0,7,#DIV/0!
POA6181,42,82,1.952380952,43,186,2.325581395,33,117,2.545454545,76,303,3.986842105,8,21,1.625,6,12,1,14,33,2.357142857,0,3,#DIV/0!
POA6182,0,0,#DIV/0!,0,0,#DIV/0!,0,0,#DIV/0!,0,0,#DIV/0!,0,0,#DIV/0!,0,0,#DIV/0!,0,0,#DIV/0!,0,0,#DIV/0!
POA6207,133,255,1.917293233,94,390,2.14893617,45,150,2.333333333,139,540,3.884892086,14,39,1.785714286,10,23,1.3,24,62,2.583333333,3,3,1
POA6208,1319,2561,1.941622441,730,2988,2.093150685,277,870,2.140794224,1007,3858,3.831181728,227,707,2.114537445,138,294,1.130434783,365,1001,2.742465753,18,32,1.777777778
POA6209,250,496,1.984,113,479,2.238938053,59,194,2.288135593,172,673,3.912790698,37,104,1.810810811,23,58,1.52173913,60,162,2.7,6,15,2.5
POA6210,7947,15475,1.947275702,4165,16596,1.984633854,1701,5373,2.158730159,5866,21969,3.745141493,1713,5018,1.929363689,1106,2413,1.181735986,2819,7431,2.636041149,196,402,2.051020408
POA6211,742,1437,1.936657682,489,1927,1.940695297,159,491,2.088050314,648,2418,3.731481481,143,427,1.986013986,67,155,1.313432836,210,582,2.771428571,8,23,2.875
POA6213,80,155,1.9375,55,237,2.309090909,24,81,2.375,79,318,4.025316456,21,53,1.523809524,13,21,0.615384615,34,74,2.176470588,3,5,1.666666667
POA6214,37,73,1.972972973,31,130,2.193548387,16,41,1.5625,47,171,3.638297872,9,27,2,7,16,1.285714286,16,43,2.6875,0,0,#DIV/0!
POA6215,444,864,1.945945946,279,1161,2.161290323,114,348,2.052631579,393,1509,3.839694656,84,275,2.273809524,60,125,1.083333333,144,400,2.777777778,9,20,2.222222222
POA6218,39,77,1.974358974,27,114,2.222222222,9,33,2.666666667,36,147,4.083333333,24,67,1.791666667,12,26,1.166666667,36,93,2.583333333,3,3,1
POA6220,522,1024,1.961685824,359,1470,2.094707521,201,620,2.084577114,560,2090,3.732142857,97,273,1.81443299,74,166,1.243243243,171,439,2.567251462,13,28,2.153846154
POA6221,47,86,1.829787234,43,184,2.279069767,15,52,2.466666667,58,236,4.068965517,6,12,1,10,23,1.3,16,35,2.1875,0,4,#DIV/0!
POA6224,126,245,1.944444444,99,414,2.181818182,43,136,2.162790698,142,550,3.873239437,35,120,2.428571429,19,36,0.894736842,54,156,2.888888889,0,0,#DIV/0!
POA6225,964,1890,1.960580913,713,2932,2.112201964,292,951,2.256849315,1005,3883,3.863681592,218,640,1.935779817,138,301,1.18115942,356,941,2.643258427,32,75,2.34375
POA6226,68,133,1.955882353,64,267,2.171875,29,93,2.206896552,93,360,3.870967742,7,28,3,10,18,0.8,17,46,2.705882353,0,0,#DIV/0!
POA6227,54,106,1.962962963,54,237,2.388888889,13,41,2.153846154,67,278,4.149253731,17,51,2,0,3,#DIV/0!,17,54,3.176470588,0,0,#DIV/0!
POA6229,51,96,1.882352941,36,160,2.444444444,20,45,1.25,56,205,3.660714286,9,25,1.777777778,7,17,1.428571429,16,42,2.625,3,6,2
POA6230,4310,8415,1.952436195,3263,13039,1.996015936,1160,3689,2.180172414,4423,16728,3.782048383,1101,3073,1.791099001,757,1642,1.169088507,1858,4715,2.537674919,139,287,2.064748201
POA6232,1045,2040,1.95215311,908,3626,1.99339207,300,966,2.22,1208,4592,3.801324503,228,625,1.74122807,121,263,1.173553719,349,888,2.544412607,27,56,2.074074074
POA6233,1743,3385,1.94205393,1580,6420,2.063291139,538,1691,2.143122677,2118,8111,3.829556185,333,992,1.978978979,190,410,1.157894737,523,1402,2.680688337,29,55,1.896551724
POA6236,233,448,1.922746781,190,800,2.210526316,72,219,2.041666667,262,1019,3.889312977,40,115,1.875,23,52,1.260869565,63,167,2.650793651,3,3,1
POA6237,337,662,1.964391691,225,924,2.106666667,111,340,2.063063063,336,1264,3.761904762,45,118,1.622222222,27,51,0.888888889,72,169,2.347222222,5,15,3
POA6239,514,1000,1.945525292,340,1388,2.082352941,137,430,2.138686131,477,1818,3.811320755,78,218,1.794871795,64,135,1.109375,142,353,2.485915493,8,19,2.375
POA6240,46,90,1.956521739,25,108,2.32,9,20,1.222222222,34,128,3.764705882,0,6,#DIV/0!,0,0,#DIV/0!,0,6,#DIV/0!,0,0,#DIV/0!
POA6244,226,425,1.880530973,140,567,2.05,33,92,1.787878788,173,659,3.809248555,25,73,1.92,17,36,1.117647059,42,109,2.595238095,4,11,2.75
POA6251,63,122,1.936507937,37,156,2.216216216,12,36,2,49,192,3.918367347,5,9,0.8,9,17,0.888888889,14,26,1.857142857,0,3,#DIV/0!
POA6253,128,239,1.8671875,27,120,2.444444444,7,20,1.857142857,34,140,4.117647059,10,35,2.5,6,7,0.166666667,16,42,2.625,0,0,#DIV/0!
POA6254,96,186,1.9375,49,194,1.959183673,17,44,1.588235294,66,238,3.606060606,17,43,1.529411765,7,15,1.142857143,24,58,2.416666667,0,0,#DIV/0!
POA6255,503,974,1.93638171,275,1143,2.156363636,75,229,2.053333333,350,1372,3.92,93,264,1.838709677,35,74,1.114285714,128,338,2.640625,7,15,2.142857143
POA6256,36,70,1.944444444,20,83,2.15,6,15,1.5,26,98,3.769230769,3,3,0,0,3,#DIV/0!,3,6,2,3,3,1
POA6258,738,1428,1.93495935,514,2152,2.186770428,170,534,2.141176471,684,2686,3.926900585,162,464,1.864197531,92,204,1.217391304,254,668,2.62992126,20,40,2
POA6260,199,394,1.979899497,144,603,2.1875,39,115,1.948717949,183,718,3.923497268,34,84,1.470588235,16,34,1.125,50,118,2.36,0,3,#DIV/0!
POA6262,111,207,1.864864865,56,217,1.875,22,59,1.681818182,78,276,3.538461538,15,51,2.4,17,30,0.764705882,32,81,2.53125,0,4,#DIV/0!
POA6271,330,649,1.966666667,232,924,1.982758621,69,216,2.130434783,301,1140,3.787375415,87,246,1.827586207,41,78,0.902439024,128,324,2.53125,3,5,1.666666667
POA6275,206,402,1.951456311,82,336,2.097560976,26,84,2.230769231,108,420,3.888888889,20,67,2.35,22,44,1,42,111,2.642857143,0,0,#DIV/0!
POA6280,2771,5404,1.950198484,1967,8021,2.077783427,638,2003,2.139498433,2605,10024,3.847984645,604,1692,1.801324503,364,788,1.164835165,968,2480,2.561983471,51,100,1.960784314
POA6281,659,1268,1.924127466,568,2178,1.834507042,111,344,2.099099099,679,2522,3.714285714,107,276,1.579439252,56,118,1.107142857,163,394,2.417177914,6,16,2.666666667
POA6282,149,293,1.966442953,133,507,1.812030075,39,111,1.846153846,172,618,3.593023256,17,37,1.176470588,8,18,1.25,25,55,2.2,0,3,#DIV/0!
POA6284,159,300,1.886792453,174,634,1.643678161,32,112,2.5,206,746,3.621359223,30,75,1.5,12,37,2.083333333,42,112,2.666666667,3,3,1
POA6285,722,1366,1.891966759,722,2796,1.872576177,173,523,2.023121387,895,3319,3.708379888,197,517,1.624365482,110,235,1.136363636,307,752,2.449511401,16,27,1.6875
POA6286,92,171,1.858695652,39,159,2.076923077,18,56,2.111111111,57,215,3.771929825,6,6,0,6,15,1.5,12,21,1.75,3,9,3
POA6288,71,130,1.830985915,29,109,1.75862069,9,23,1.555555556,38,132,3.473684211,8,15,0.875,3,9,2,11,24,2.181818182,0,0,#DIV/0!
POA6290,267,525,1.966292135,92,334,1.630434783,33,101,2.060606061,125,435,3.48,22,77,2.5,16,27,0.6875,38,104,2.736842105,5,11,2.2
POA6302,502,975,1.942231076,248,971,1.915322581,85,271,2.188235294,333,1242,3.72972973,79,241,2.050632911,49,95,0.93877551,128,336,2.625,7,12,1.714285714
POA6304,248,473,1.907258065,108,442,2.092592593,40,104,1.6,148,546,3.689189189,26,82,2.153846154,19,36,0.894736842,45,118,2.622222222,6,19,3.166666667
POA6306,117,233,1.991452991,71,302,2.253521127,28,73,1.607142857,99,375,3.787878788,13,35,1.692307692,4,12,2,17,47,2.764705882,3,5,1.666666667
POA6308,231,451,1.952380952,132,514,1.893939394,36,109,2.027777778,168,623,3.708333333,40,115,1.875,20,41,1.05,60,156,2.6,5,10,2
POA6309,45,84,1.866666667,22,90,2.090909091,4,17,3.25,26,107,4.115384615,4,11,1.75,4,7,0.75,8,18,2.25,0,0,#DIV/0!
POA6311,84,165,1.964285714,65,238,1.661538462,10,39,2.9,75,277,3.693333333,11,41,2.727272727,7,12,0.714285714,18,53,2.944444444,0,0,#DIV/0!
POA6312,510,989,1.939215686,399,1660,2.160401003,103,326,2.165048544,502,1986,3.956175299,128,378,1.953125,67,135,1.014925373,195,513,2.630769231,20,38,1.9
POA6313,53,97,1.830188679,32,130,2.0625,13,35,1.692307692,45,165,3.666666667,6,19,2.166666667,7,12,0.714285714,13,31,2.384615385,3,4,1.333333333
POA6315,242,472,1.950413223,155,650,2.193548387,35,111,2.171428571,190,761,4.005263158,35,114,2.257142857,27,55,1.037037037,62,169,2.725806452,4,9,2.25
POA6316,54,101,1.87037037,43,167,1.88372093,7,20,1.857142857,50,187,3.74,13,40,2.076923077,3,8,1.666666667,16,48,3,0,0,#DIV/0!
POA6317,436,861,1.974770642,365,1558,2.268493151,102,314,2.078431373,467,1872,4.00856531,126,402,2.19047619,34,75,1.205882353,160,477,2.98125,22,44,2
POA6318,22,49,2.227272727,17,82,2.823529412,10,25,1.5,27,107,3.962962963,13,29,1.230769231,8,15,0.875,21,44,2.095238095,0,0,#DIV/0!
POA6320,98,197,2.010204082,93,366,1.935483871,20,60,2,113,426,3.769911504,22,91,3.136363636,7,11,0.571428571,29,102,3.517241379,3,5,1.666666667
POA6321,30,59,1.966666667,14,75,3.357142857,7,18,1.571428571,21,93,4.428571429,14,45,2.214285714,3,6,1,17,51,3,0,0,#DIV/0!
POA6322,72,148,2.055555556,41,157,1.829268293,9,35,2.888888889,50,192,3.84,6,11,0.833333333,3,5,0.666666667,9,16,1.777777778,3,3,1
POA6323,137,268,1.95620438,76,289,1.802631579,18,60,2.333333333,94,349,3.712765957,26,73,1.807692308,15,29,0.933333333,41,102,2.487804878,3,9,3
POA6324,407,781,1.918918919,237,971,2.097046414,73,229,2.136986301,310,1200,3.870967742,82,236,1.87804878,46,100,1.173913043,128,336,2.625,11,29,2.636363636
POA6326,74,148,2,34,140,2.117647059,27,83,2.074074074,61,223,3.655737705,6,25,3.166666667,13,26,1,19,51,2.684210526,0,0,#DIV/0!
POA6327,37,70,1.891891892,26,113,2.346153846,10,34,2.4,36,147,4.083333333,4,9,1.25,4,10,1.5,8,19,2.375,3,4,1.333333333
POA6328,58,115,1.982758621,35,149,2.257142857,14,38,1.714285714,49,187,3.816326531,6,9,0.5,3,10,2.333333333,9,19,2.111111111,0,3,#DIV/0!
POA6330,3818,7422,1.943949712,2604,10744,2.125960061,922,2912,2.15835141,3526,13656,3.872943846,773,2215,1.86545925,543,1182,1.17679558,1316,3397,2.581306991,116,235,2.025862069
POA6333,726,1410,1.94214876,380,1496,1.936842105,106,313,1.952830189,486,1809,3.722222222,149,395,1.651006711,66,136,1.060606061,215,531,2.469767442,10,22,2.2
POA6335,86,166,1.930232558,86,364,2.23255814,10,41,3.1,96,405,4.21875,14,58,3.142857143,11,16,0.454545455,25,74,2.96,3,3,1
POA6336,36,70,1.944444444,21,81,1.857142857,6,10,0.666666667,27,91,3.37037037,4,13,2.25,4,8,1,8,21,2.625,0,0,#DIV/0!
POA6337,55,105,1.909090909,48,181,1.770833333,20,51,1.55,68,232,3.411764706,13,25,0.923076923,3,11,2.666666667,16,36,2.25,0,0,#DIV/0!
POA6338,75,145,1.933333333,79,303,1.835443038,17,45,1.647058824,96,348,3.625,0,8,#DIV/0!,6,7,0.166666667,6,15,2.5,4,5,1.25
POA6341,42,80,1.904761905,30,116,1.866666667,5,18,2.6,35,134,3.828571429,0,6,#DIV/0!,4,0,-1,4,6,1.5,4,3,0.75
POA6343,29,63,2.172413793,31,122,1.935483871,0,6,#DIV/0!,31,128,4.129032258,3,3,0,6,6,0,9,9,1,0,0,#DIV/0!
POA6346,69,126,1.826086957,54,219,2.055555556,12,35,1.916666667,66,254,3.848484848,11,36,2.272727273,5,8,0.6,16,44,2.75,3,4,1.333333333
POA6348,177,346,1.95480226,138,555,2.02173913,17,50,1.941176471,155,605,3.903225806,13,39,2,8,19,1.375,21,58,2.761904762,0,5,#DIV/0!
POA6350,37,67,1.810810811,11,41,1.727272727,3,12,3,14,53,3.785714286,6,18,2,4,7,0.75,10,25,2.5,0,0,#DIV/0!
POA6352,57,112,1.964912281,47,183,1.893617021,6,20,2.333333333,53,203,3.830188679,0,0,#DIV/0!,4,0,-1,4,0,0,0,4,#DIV/0!
POA6353,99,193,1.949494949,72,271,1.763888889,15,42,1.8,87,313,3.597701149,7,26,2.714285714,6,10,0.666666667,13,36,2.769230769,3,4,1.333333333
POA6355,110,208,1.890909091,92,350,1.804347826,13,37,1.846153846,105,387,3.685714286,4,20,4,5,7,0.4,9,27,3,0,6,#DIV/0!
POA6358,42,85,2.023809524,20,69,1.45,5,17,2.4,25,86,3.44,3,8,1.666666667,3,3,0,6,11,1.833333333,0,0,#DIV/0!
POA6359,42,82,1.952380952,45,172,1.822222222,3,8,1.666666667,48,180,3.75,0,5,#DIV/0!,3,0,-1,3,5,1.666666667,0,3,#DIV/0!
POA6365,82,162,1.975609756,54,225,2.166666667,13,29,1.230769231,67,254,3.791044776,9,34,2.777777778,3,6,1,12,40,3.333333333,4,6,1.5
POA6367,35,64,1.828571429,23,93,2.043478261,0,4,#DIV/0!,23,97,4.217391304,7,35,4,4,6,0.5,11,41,3.727272727,3,3,1
POA6368,36,62,1.722222222,18,73,2.055555556,5,14,1.8,23,87,3.782608696,0,0,#DIV/0!,0,6,#DIV/0!,0,6,#DIV/0!,0,4,#DIV/0!
POA6369,96,194,2.020833333,46,188,2.086956522,17,47,1.764705882,63,235,3.73015873,9,25,1.777777778,9,14,0.555555556,18,39,2.166666667,0,3,#DIV/0!
POA6370,69,129,1.869565217,42,181,2.30952381,11,26,1.363636364,53,207,3.905660377,21,55,1.619047619,12,20,0.666666667,33,75,2.272727273,0,3,#DIV/0!
POA6373,34,66,1.941176471,27,95,1.518518519,9,29,2.222222222,36,124,3.444444444,0,4,#DIV/0!,0,0,#DIV/0!,0,4,#DIV/0!,0,0,#DIV/0!
POA6375,129,253,1.96124031,47,195,2.14893617,15,38,1.533333333,62,233,3.758064516,15,50,2.333333333,11,25,1.272727273,26,75,2.884615385,3,3,1
POA6383,169,323,1.911242604,69,287,2.15942029,19,60,2.157894737,88,347,3.943181818,30,94,2.133333333,4,13,2.25,34,107,3.147058824,4,7,1.75
POA6386,31,55,1.774193548,30,120,2,6,24,3,36,144,4,0,4,#DIV/0!,0,0,#DIV/0!,0,4,#DIV/0!,0,0,#DIV/0!
POA6390,186,352,1.892473118,159,628,1.949685535,47,146,2.106382979,206,774,3.757281553,37,107,1.891891892,13,28,1.153846154,50,135,2.7,6,10,1.666666667
POA6391,147,289,1.965986395,73,295,2.04109589,25,69,1.76,98,364,3.714285714,12,31,1.583333333,12,29,1.416666667,24,60,2.5,0,0,#DIV/0!
POA6392,74,141,1.905405405,50,200,2,10,24,1.4,60,224,3.733333333,6,22,2.666666667,6,8,0.333333333,12,30,2.5,0,0,#DIV/0!
POA6393,63,122,1.936507937,42,154,1.666666667,7,24,2.428571429,49,178,3.632653061,3,6,1,3,7,1.333333333,6,13,2.166666667,0,0,#DIV/0!
POA6394,57,108,1.894736842,43,176,2.093023256,16,41,1.5625,59,217,3.677966102,0,7,#DIV/0!,6,18,2,6,25,4.166666667,0,0,#DIV/0!
POA6395,204,399,1.955882353,127,506,1.984251969,37,110,1.972972973,164,616,3.756097561,38,111,1.921052632,17,35,1.058823529,55,146,2.654545455,6,9,1.5
POA6396,34,71,2.088235294,39,136,1.487179487,6,20,2.333333333,45,156,3.466666667,4,8,1,9,14,0.555555556,13,22,1.692307692,0,0,#DIV/0!
POA6397,35,66,1.885714286,26,99,1.807692308,5,17,2.4,31,116,3.741935484,6,12,1,3,6,1,9,18,2,0,4,#DIV/0!
POA6398,92,177,1.923913043,39,155,1.974358974,8,26,2.25,47,181,3.85106383,10,34,2.4,8,12,0.5,18,46,2.555555556,0,0,#DIV/0!
POA6401,804,1574,1.957711443,567,2334,2.116402116,171,542,2.169590643,738,2876,3.89701897,198,621,2.136363636,135,305,1.259259259,333,926,2.780780781,31,59,1.903225806
POA6403,25,55,2.2,16,73,2.5625,4,11,1.75,20,84,4.2,6,13,1.166666667,3,12,3,9,25,2.777777778,0,0,#DIV/0!
POA6405,39,79,2.025641026,26,93,1.576923077,10,25,1.5,36,118,3.277777778,3,13,3.333333333,5,7,0.4,8,20,2.5,0,0,#DIV/0!
POA6407,124,241,1.943548387,78,305,1.91025641,27,89,2.296296296,105,394,3.752380952,18,51,1.833333333,10,23,1.3,28,74,2.642857143,3,4,1.333333333
POA6409,40,81,2.025,45,172,1.822222222,3,10,2.333333333,48,182,3.791666667,7,20,1.857142857,4,16,3,11,36,3.272727273,3,5,1.666666667
POA6410,145,278,1.917241379,101,432,2.277227723,27,73,1.703703704,128,505,3.9453125,29,88,2.034482759,10,20,1,39,108,2.769230769,3,7,2.333333333
POA6413,33,62,1.878787879,11,44,2,7,15,1.142857143,18,59,3.277777778,0,0,#DIV/0!,4,7,0.75,4,7,1.75,0,0,#DIV/0!
POA6415,304,591,1.944078947,232,943,2.064655172,66,200,2.03030303,298,1143,3.83557047,61,180,1.950819672,34,73,1.147058824,95,253,2.663157895,12,27,2.25
POA6418,115,212,1.843478261,60,238,1.966666667,7,27,2.857142857,67,265,3.955223881,16,53,2.3125,7,15,1.142857143,23,68,2.956521739,0,3,#DIV/0!
POA6421,28,63,2.25,23,111,2.826086957,10,26,1.6,33,137,4.151515152,3,3,0,0,0,#DIV/0!,3,3,1,3,3,1
POA6423,35,67,1.914285714,23,76,1.304347826,6,15,1.5,29,91,3.137931034,3,9,2,0,3,#DIV/0!,3,12,4,0,0,#DIV/0!
POA6425,27,45,1.666666667,16,53,1.3125,7,18,1.571428571,23,71,3.086956522,0,8,#DIV/0!,0,0,#DIV/0!,0,8,#DIV/0!,0,0,#DIV/0!
POA6426,105,200,1.904761905,98,383,1.908163265,22,61,1.772727273,120,444,3.7,29,75,1.586206897,11,28,1.545454545,40,103,2.575,0,0,#DIV/0!
POA6429,112,223,1.991071429,76,323,2.25,21,81,2.857142857,97,404,4.164948454,42,126,2,24,55,1.291666667,66,181,2.742424242,3,4,1.333333333
POA6430,1995,3897,1.953383459,2161,8793,2.06894956,577,1854,2.213171577,2738,10647,3.888604821,427,1250,1.927400468,257,573,1.229571984,684,1823,2.665204678,83,169,2.036144578
POA6431,27,66,2.444444444,50,219,2.38,10,42,3.2,60,261,4.35,41,144,2.512195122,11,38,2.454545455,52,182,3.5,5,11,2.2
POA6432,650,1269,1.952307692,644,2594,2.027950311,166,532,2.204819277,810,3126,3.859259259,211,644,2.052132701,109,236,1.165137615,320,880,2.75,33,68,2.060606061
POA6434,3,15,5,8,44,3.5,3,5,0.666666667,11,49,4.454545455,9,43,3.777777778,6,19,2.166666667,15,62,4.133333333,3,3,1
POA6436,12,22,1.833333333,12,39,1.25,0,4,#DIV/0!,12,43,3.583333333,5,22,3.4,4,7,0.75,9,29,3.222222222,0,0,#DIV/0!
POA6437,43,87,2.023255814,91,351,1.857142857,4,18,3.5,95,369,3.884210526,4,11,1.75,0,10,#DIV/0!,4,21,5.25,0,0,#DIV/0!
POA6438,59,116,1.966101695,39,163,2.179487179,10,36,2.6,49,199,4.06122449,25,68,1.72,6,16,1.666666667,31,84,2.709677419,3,5,1.666666667
POA6440,50,98,1.96,32,160,3,7,13,0.857142857,39,173,4.435897436,20,58,1.9,11,25,1.272727273,31,83,2.677419355,0,7,#DIV/0!
POA6442,211,420,1.990521327,303,1242,2.099009901,53,152,1.867924528,356,1394,3.915730337,62,177,1.85483871,24,57,1.375,86,234,2.720930233,5,7,1.4
POA6443,98,189,1.928571429,66,270,2.090909091,5,27,4.4,71,297,4.183098592,38,114,2,14,28,1,52,142,2.730769231,3,4,1.333333333
POA6445,19,36,1.894736842,20,72,1.6,5,13,1.6,25,85,3.4,0,3,#DIV/0!,3,8,1.666666667,3,11,3.666666667,0,0,#DIV/0!
POA6447,41,87,2.12195122,58,255,2.396551724,11,33,2,69,288,4.173913043,6,21,2.5,5,4,-0.2,11,25,2.272727273,0,0,#DIV/0!
POA6448,45,90,2,32,132,2.125,9,22,1.444444444,41,154,3.756097561,10,25,1.5,3,8,1.666666667,13,33,2.538461538,0,0,#DIV/0!
POA6450,1329,2577,1.939051919,1060,4274,2.032075472,331,1038,2.135951662,1391,5312,3.81883537,294,843,1.867346939,179,373,1.083798883,473,1216,2.570824524,36,76,2.111111111
POA6460,136,259,1.904411765,88,355,2.034090909,18,53,1.944444444,106,408,3.849056604,20,68,2.4,7,7,0,27,75,2.777777778,4,9,2.25
POA6461,60,118,1.966666667,30,118,1.933333333,6,10,0.666666667,36,128,3.555555556,7,22,2.142857143,5,10,1,12,32,2.666666667,0,3,#DIV/0!
POA6462,46,93,2.02173913,28,132,2.714285714,15,35,1.333333333,43,167,3.88372093,3,6,1,0,3,#DIV/0!,3,9,3,0,0,#DIV/0!
POA6468,21,44,2.095238095,25,92,1.68,8,29,2.625,33,121,3.666666667,0,9,#DIV/0!,0,0,#DIV/0!,0,9,#DIV/0!,0,0,#DIV/0!
POA6472,29,51,1.75862069,17,68,2,6,16,1.666666667,23,84,3.652173913,3,10,2.333333333,0,0,#DIV/0!,3,10,3.333333333,0,0,#DIV/0!
POA6475,57,102,1.789473684,45,179,1.977777778,4,11,1.75,49,190,3.87755102,5,19,2.8,7,17,1.428571429,12,36,3,0,0,#DIV/0!
POA6477,40,73,1.825,28,119,2.25,8,27,2.375,36,146,4.055555556,3,6,1,0,3,#DIV/0!,3,9,3,0,0,#DIV/0!
POA6479,91,176,1.934065934,37,160,2.324324324,19,54,1.842105263,56,214,3.821428571,4,15,2.75,3,7,1.333333333,7,22,3.142857143,0,0,#DIV/0!
POA6484,9,17,1.888888889,7,17,0.428571429,0,3,#DIV/0!,7,20,2.857142857,0,0,#DIV/0!,0,0,#DIV/0!,0,0,#DIV/0!,0,0,#DIV/0!
POA6485,62,124,2,38,139,1.657894737,10,29,1.9,48,168,3.5,14,40,1.857142857,3,3,0,17,43,2.529411765,3,3,1
POA6488,54,106,1.962962963,29,100,1.448275862,3,17,4.666666667,32,117,3.65625,7,29,3.142857143,3,3,0,10,32,3.2,3,4,1.333333333
POA6490,29,50,1.724137931,13,57,2.384615385,9,24,1.666666667,22,81,3.681818182,8,25,2.125,0,6,#DIV/0!,8,31,3.875,0,0,#DIV/0!
POA6501,128,246,1.921875,102,427,2.18627451,38,118,2.105263158,140,545,3.892857143,14,50,2.571428571,11,20,0.818181818,25,70,2.8,0,3,#DIV/0!
POA6502,148,279,1.885135135,65,271,2.169230769,37,113,2.054054054,102,384,3.764705882,27,76,1.814814815,14,35,1.5,41,111,2.707317073,0,4,#DIV/0!
POA6503,258,511,1.980620155,191,771,2.036649215,53,168,2.169811321,244,939,3.848360656,32,98,2.0625,20,34,0.7,52,132,2.538461538,5,6,1.2
POA6505,45,87,1.933333333,21,99,2.714285714,10,28,1.8,31,127,4.096774194,0,9,#DIV/0!,0,0,#DIV/0!,0,9,#DIV/0!,0,0,#DIV/0!
POA6507,69,130,1.884057971,37,133,1.594594595,10,24,1.4,47,157,3.340425532,4,11,1.75,0,5,#DIV/0!,4,16,4,4,3,0.75
POA6509,36,77,2.138888889,33,104,1.151515152,7,24,2.428571429,40,128,3.2,0,6,#DIV/0!,5,6,0.2,5,12,2.4,0,4,#DIV/0!
POA6510,227,435,1.916299559,174,716,2.114942529,56,164,1.928571429,230,880,3.826086957,50,161,2.22,31,63,1.032258065,81,224,2.765432099,3,0,0
POA6511,85,166,1.952941176,24,103,2.291666667,7,16,1.285714286,31,119,3.838709677,12,27,1.25,3,9,2,15,36,2.4,0,3,#DIV/0!
POA6513,19,36,1.894736842,26,94,1.615384615,0,11,#DIV/0!,26,105,4.038461538,3,8,1.666666667,0,3,#DIV/0!,3,11,3.666666667,3,3,1
POA6514,101,195,1.930693069,29,118,2.068965517,12,32,1.666666667,41,150,3.658536585,17,47,1.764705882,3,7,1.333333333,20,54,2.7,0,0,#DIV/0!
POA6515,65,121,1.861538462,34,159,2.676470588,20,51,1.55,54,210,3.888888889,4,14,2.5,0,3,#DIV/0!,4,17,4.25,4,5,1.25
POA6516,195,382,1.958974359,129,504,1.906976744,19,50,1.631578947,148,554,3.743243243,31,93,2,10,25,1.5,41,118,2.87804878,5,6,1.2
POA6517,54,101,1.87037037,42,158,1.761904762,6,13,1.166666667,48,171,3.5625,6,13,1.166666667,3,6,1,9,19,2.111111111,0,0,#DIV/0!
POA6518,13,24,1.846153846,10,32,1.2,3,3,0,13,35,2.692307692,3,3,0,0,3,#DIV/0!,3,6,2,0,3,#DIV/0!
POA6519,86,165,1.918604651,58,230,1.965517241,3,11,2.666666667,61,241,3.950819672,17,47,1.764705882,4,7,0.75,21,54,2.571428571,0,3,#DIV/0!
POA6521,50,98,1.96,29,109,1.75862069,14,29,1.071428571,43,138,3.209302326,3,13,3.333333333,3,6,1,6,19,3.166666667,3,3,1
POA6522,55,111,2.018181818,45,188,2.177777778,9,21,1.333333333,54,209,3.87037037,12,40,2.333333333,6,12,1,18,52,2.888888889,3,8,2.666666667
POA6525,483,911,1.886128364,294,1201,2.085034014,98,275,1.806122449,392,1476,3.765306122,72,216,2,32,63,0.96875,104,279,2.682692308,5,9,1.8
POA6528,40,74,1.85,20,83,2.15,9,32,2.555555556,29,115,3.965517241,4,17,3.25,8,18,1.25,12,35,2.916666667,0,0,#DIV/0!
POA6530,3219,6213,1.930102516,2616,10681,2.08295107,949,2953,2.111696523,3565,13634,3.824403927,982,2938,1.99185336,545,1201,1.203669725,1527,4139,2.710543549,108,215,1.990740741
POA6532,679,1301,1.916053019,550,2199,1.998181818,166,504,2.036144578,716,2703,3.775139665,85,244,1.870588235,60,132,1.2,145,376,2.593103448,8,20,2.5
POA6535,244,459,1.881147541,87,355,2.08045977,37,106,1.864864865,124,461,3.717741935,35,118,2.371428571,30,57,0.9,65,175,2.692307692,5,11,2.2
POA6536,228,432,1.894736842,127,497,1.913385827,22,68,2.090909091,149,565,3.791946309,22,57,1.590909091,13,33,1.538461538,35,90,2.571428571,3,5,1.666666667
POA6537,101,201,1.99009901,41,144,1.512195122,7,23,2.285714286,48,167,3.479166667,14,38,1.714285714,8,13,0.625,22,51,2.318181818,0,3,#DIV/0!
POA6556,207,406,1.961352657,164,674,2.109756098,84,279,2.321428571,248,953,3.842741935,37,104,1.810810811,42,79,0.880952381,79,183,2.316455696,0,6,#DIV/0!
POA6558,97,191,1.969072165,65,262,2.030769231,30,109,2.633333333,95,371,3.905263158,20,54,1.7,3,10,2.333333333,23,64,2.782608696,3,3,1
POA6560,126,244,1.936507937,99,428,2.323232323,38,129,2.394736842,137,557,4.065693431,46,145,2.152173913,34,71,1.088235294,80,216,2.7,3,3,1
POA6562,181,351,1.939226519,85,340,2,30,87,1.9,115,427,3.713043478,25,79,2.16,10,22,1.2,35,101,2.885714286,3,8,2.666666667
POA6564,48,96,2,21,71,1.380952381,10,35,2.5,31,106,3.419354839,11,29,1.636363636,7,12,0.714285714,18,41,2.277777778,0,0,#DIV/0!
POA6566,454,874,1.925110132,199,796,2,90,277,2.077777778,289,1073,3.712802768,86,239,1.779069767,44,95,1.159090909,130,334,2.569230769,8,14,1.75
POA6567,71,128,1.802816901,23,102,2.434782609,14,35,1.5,37,137,3.702702703,6,25,3.166666667,6,8,0.333333333,12,33,2.75,0,0,#DIV/0!
POA6568,25,48,1.92,28,127,2.535714286,6,17,1.833333333,34,144,4.235294118,3,4,0.333333333,3,6,1,6,10,1.666666667,0,0,#DIV/0!
POA6569,41,76,1.853658537,31,115,1.709677419,3,8,1.666666667,34,123,3.617647059,3,18,5,3,5,0.666666667,6,23,3.833333333,3,4,1.333333333
POA6575,34,57,1.676470588,26,104,2,6,10,0.666666667,32,114,3.5625,0,6,#DIV/0!,3,10,2.333333333,3,16,5.333333333,0,0,#DIV/0!
POA6603,121,234,1.933884298,103,405,1.932038835,21,50,1.380952381,124,455,3.669354839,28,104,2.714285714,7,21,2,35,125,3.571428571,3,5,1.666666667
POA6606,47,91,1.936170213,32,114,1.5625,4,12,2,36,126,3.5,0,10,#DIV/0!,5,9,0.8,5,19,3.8,4,5,1.25
POA6608,31,60,1.935483871,22,92,2.181818182,12,35,1.916666667,34,127,3.735294118,0,0,#DIV/0!,5,8,0.6,5,8,1.6,0,0,#DIV/0!
POA6609,60,121,2.016666667,51,217,2.254901961,18,51,1.833333333,69,268,3.884057971,8,19,1.375,5,8,0.6,13,27,2.076923077,0,0,#DIV/0!
POA6612,30,57,1.9,23,93,2.043478261,6,14,1.333333333,29,107,3.689655172,4,16,3,0,4,#DIV/0!,4,20,5,4,4,1
POA6620,22,42,1.909090909,21,86,2.095238095,4,5,0.25,25,91,3.64,6,14,1.333333333,0,4,#DIV/0!,6,18,3,0,0,#DIV/0!
POA6623,126,250,1.984126984,117,480,2.102564103,23,60,1.608695652,140,540,3.857142857,25,70,1.8,10,18,0.8,35,88,2.514285714,0,3,#DIV/0!
POA6628,14,35,2.5,27,101,1.740740741,5,15,2,32,116,3.625,0,0,#DIV/0!,3,7,1.333333333,3,7,2.333333333,4,3,0.75
POA6630,48,97,2.020833333,27,117,2.333333333,6,16,1.666666667,33,133,4.03030303,15,53,2.533333333,12,30,1.5,27,83,3.074074074,0,0,#DIV/0!
POA6635,29,62,2.137931034,18,76,2.222222222,8,19,1.375,26,95,3.653846154,9,38,3.222222222,6,6,0,15,44,2.933333333,0,3,#DIV/0!
POA6638,47,97,2.063829787,39,163,2.179487179,11,33,2,50,196,3.92,18,77,3.277777778,7,8,0.142857143,25,85,3.4,10,12,1.2
POA6639,19,37,1.947368421,4,12,1,4,15,2.75,8,27,3.375,0,3,#DIV/0!,0,0,#DIV/0!,0,3,#DIV/0!,0,0,#DIV/0!
POA6640,32,62,1.9375,11,53,2.818181818,4,15,2.75,15,68,4.533333333,9,27,2,0,3,#DIV/0!,9,30,3.333333333,0,4,#DIV/0!
POA6642,81,159,1.962962963,54,241,2.462962963,15,49,2.266666667,69,290,4.202898551,30,93,2.1,15,36,1.4,45,129,2.866666667,5,13,2.6
POA6646,24,57,2.375,26,141,3.423076923,4,9,1.25,30,150,5,25,97,2.88,14,35,1.5,39,132,3.384615385,3,0,0
POA6701,569,1101,1.934973638,435,1770,2.068965517,114,358,2.140350877,549,2128,3.876138434,154,491,2.188311688,78,179,1.294871795,232,670,2.887931034,19,44,2.315789474
POA6705,18,34,1.888888889,14,64,2.571428571,5,5,0,19,69,3.631578947,18,75,3.166666667,0,3,#DIV/0!,18,78,4.333333333,0,0,#DIV/0!
POA6707,302,594,1.966887417,210,781,1.719047619,34,88,1.588235294,244,869,3.56147541,43,111,1.581395349,21,47,1.238095238,64,158,2.46875,0,3,#DIV/0!
POA6710,79,157,1.987341772,55,225,2.090909091,10,33,2.3,65,258,3.969230769,24,74,2.083333333,13,19,0.461538462,37,93,2.513513514,3,10,3.333333333
POA6713,102,192,1.882352941,110,409,1.718181818,42,128,2.047619048,152,537,3.532894737,8,26,2.25,3,10,2.333333333,11,36,3.272727273,3,6,2
POA6714,1247,2446,1.961507618,1456,5847,2.015796703,341,1108,2.249266862,1797,6955,3.870339455,170,475,1.794117647,104,228,1.192307692,274,703,2.565693431,33,69,2.090909091
POA6716,43,83,1.930232558,82,312,1.804878049,6,9,0.5,88,321,3.647727273,8,20,1.5,0,0,#DIV/0!,8,20,2.5,0,0,#DIV/0!
POA6718,67,133,1.985074627,49,219,2.469387755,14,53,2.785714286,63,272,4.317460317,34,127,2.735294118,25,55,1.2,59,182,3.084745763,14,40,2.857142857
POA6720,121,236,1.950413223,212,870,2.103773585,47,152,2.234042553,259,1022,3.945945946,34,129,2.794117647,17,34,1,51,163,3.196078431,3,7,2.333333333
POA6721,359,706,1.966573816,346,1367,1.950867052,86,272,2.162790698,432,1639,3.793981481,26,70,1.692307692,24,54,1.25,50,124,2.48,14,33,2.357142857
POA6722,720,1410,1.958333333,790,3218,2.073417722,203,653,2.216748768,993,3871,3.898288016,174,550,2.16091954,100,232,1.32,274,782,2.854014599,55,112,2.036363636
POA6725,705,1389,1.970212766,809,3347,2.137206428,140,474,2.385714286,949,3821,4.026343519,316,992,2.139240506,121,287,1.371900826,437,1279,2.926773455,47,115,2.446808511
POA6726,505,964,1.908910891,419,1682,2.014319809,94,292,2.106382979,513,1974,3.847953216,166,506,2.048192771,77,161,1.090909091,243,667,2.744855967,11,28,2.545454545
POA6728,313,627,2.003194888,390,1762,2.517948718,47,158,2.361702128,437,1920,4.393592677,207,752,2.632850242,72,203,1.819444444,279,955,3.422939068,35,103,2.942857143
POA6740,83,172,2.072289157,106,519,2.896226415,6,28,3.666666667,112,547,4.883928571,87,329,2.781609195,18,50,1.777777778,105,379,3.60952381,22,39,1.772727273
POA6743,592,1137,1.920608108,475,1982,2.172631579,69,213,2.086956522,544,2195,4.034926471,185,660,2.567567568,56,143,1.553571429,241,803,3.331950207,17,48,2.823529412
POA6751,259,510,1.969111969,436,1753,2.020642202,47,145,2.085106383,483,1898,3.929606625,58,171,1.948275862,22,46,1.090909091,80,217,2.7125,3,10,3.333333333
POA6753,357,704,1.971988796,560,2332,2.164285714,105,354,2.371428571,665,2686,4.039097744,69,214,2.101449275,25,55,1.2,94,269,2.861702128,6,21,3.5
POA6754,116,223,1.922413793,164,665,2.054878049,16,53,2.3125,180,718,3.988888889,16,52,2.25,8,14,0.75,24,66,2.75,4,6,1.5
POA6758,15,29,1.933333333,15,74,2.933333333,0,12,#DIV/0!,15,86,5.733333333,9,22,1.444444444,3,4,0.333333333,12,26,2.166666667,0,3,#DIV/0!
POA6760,16,24,1.5,31,169,3.451612903,6,12,1,37,181,4.891891892,27,143,4.296296296,7,28,3,34,171,5.029411765,6,18,3
POA6762,9,21,2.333333333,21,104,2.952380952,4,17,3.25,25,121,4.84,19,73,2.842105263,6,22,2.666666667,25,95,3.8,3,3,1
POA6765,81,173,2.135802469,92,434,2.717391304,16,74,3.625,108,508,4.703703704,81,289,2.567901235,23,61,1.652173913,104,350,3.365384615,22,51,2.318181818
POA6770,132,290,2.196969697,225,1169,3.195555556,29,117,3.034482759,254,1286,5.062992126,166,676,3.072289157,45,132,1.933333333,211,808,3.829383886,27,63,2.333333333
POA6907,9,21,2.333333333,3,14,2.666666667,3,7,1.333333333,6,21,3.5,0,3,#DIV/0!,0,0,#DIV/0!,0,3,#DIV/0!,3,7,2.333333333
POA7000,1314,2579,1.962709285,875,3416,1.904,330,1056,2.2,1205,4472,3.71120332,250,619,1.476,250,539,1.156,500,1158,2.316,58,122,2.103448276
POA7004,801,1574,1.965043695,452,1751,1.873893805,153,483,2.156862745,605,2234,3.692561983,126,314,1.492063492,127,282,1.220472441,253,596,2.355731225,28,62,2.214285714
POA7005,1502,2932,1.952063915,729,2880,1.950617284,405,1302,2.214814815,1134,4182,3.687830688,125,315,1.52,173,366,1.115606936,298,681,2.285234899,66,135,2.045454545
POA7007,325,630,1.938461538,231,940,2.069264069,107,346,2.23364486,338,1286,3.804733728,59,158,1.677966102,48,100,1.083333333,107,258,2.411214953,10,27,2.7
POA7008,1109,2173,1.959422904,890,3489,1.920224719,404,1365,2.378712871,1294,4854,3.751159196,270,734,1.718518519,261,554,1.122605364,531,1288,2.425612053,59,119,2.016949153
POA7009,1103,2192,1.987307344,847,3426,2.044864227,384,1253,2.263020833,1231,4679,3.800974817,458,1326,1.895196507,342,749,1.19005848,800,2075,2.59375,72,147,2.041666667
POA7010,1558,3093,1.985237484,969,3973,2.100103199,477,1577,2.306079665,1446,5550,3.838174274,604,1746,1.890728477,437,960,1.196796339,1041,2706,2.599423631,84,169,2.011904762
POA7011,1501,2999,1.998001332,1023,4128,2.035190616,482,1571,2.2593361,1505,5699,3.786710963,527,1455,1.760910816,342,743,1.17251462,869,2198,2.529344074,61,133,2.180327869
POA7012,86,176,2.046511628,76,315,2.144736842,42,125,1.976190476,118,440,3.728813559,25,66,1.64,9,21,1.333333333,34,87,2.558823529,3,6,2
POA7015,1227,2405,1.9600652,709,2816,1.971791255,367,1183,2.223433243,1076,3999,3.716542751,192,509,1.651041667,224,490,1.1875,416,999,2.401442308,31,56,1.806451613
POA7016,184,363,1.972826087,162,682,2.209876543,59,194,2.288135593,221,876,3.963800905,123,337,1.739837398,81,190,1.345679012,204,527,2.583333333,10,27,2.7
POA7017,571,1123,1.966725044,479,1895,1.956158664,198,651,2.287878788,677,2546,3.76070901,85,241,1.835294118,58,138,1.379310345,143,379,2.65034965,5,14,2.8
POA7018,2391,4732,1.979088248,1414,5626,1.978783593,681,2190,2.215859031,2095,7816,3.730787589,520,1431,1.751923077,485,1045,1.154639175,1005,2476,2.463681592,92,191,2.076086957
POA7019,448,894,1.995535714,405,1677,2.140740741,134,445,2.320895522,539,2122,3.936920223,303,930,2.069306931,165,368,1.23030303,468,1298,2.773504274,21,47,2.238095238
POA7020,244,476,1.950819672,240,974,2.058333333,144,470,2.263888889,384,1444,3.760416667,34,97,1.852941176,36,79,1.194444444,70,176,2.514285714,0,0,#DIV/0!
POA7021,271,525,1.937269373,209,818,1.913875598,101,344,2.405940594,310,1162,3.748387097,47,135,1.872340426,45,98,1.177777778,92,233,2.532608696,4,14,3.5
POA7022,117,228,1.948717949,66,266,2.03030303,24,80,2.333333333,90,346,3.844444444,22,60,1.727272727,16,31,0.9375,38,91,2.394736842,0,0,#DIV/0!
POA7023,56,106,1.892857143,24,92,1.833333333,9,29,2.222222222,33,121,3.666666667,3,12,3,6,12,1,9,24,2.666666667,0,3,#DIV/0!
POA7024,51,99,1.941176471,42,156,1.714285714,18,58,2.222222222,60,214,3.566666667,16,44,1.75,6,11,0.833333333,22,55,2.5,3,3,1
POA7025,237,470,1.983122363,162,658,2.061728395,85,299,2.517647059,247,957,3.874493927,29,84,1.896551724,11,26,1.363636364,40,110,2.75,3,8,2.666666667
POA7026,112,221,1.973214286,71,281,1.957746479,35,111,2.171428571,106,392,3.698113208,18,52,1.888888889,9,24,1.666666667,27,76,2.814814815,0,0,#DIV/0!
POA7027,44,92,2.090909091,21,98,2.666666667,13,43,2.307692308,34,141,4.147058824,13,29,1.230769231,6,19,2.166666667,19,48,2.526315789,0,0,#DIV/0!
POA7030,1520,3024,1.989473684,1359,5638,2.148638705,543,1766,2.252302026,1902,7404,3.892744479,793,2326,1.933165195,358,781,1.181564246,1151,3107,2.699391833,54,103,1.907407407
POA7050,1286,2543,1.977449456,956,3867,2.044979079,381,1257,2.299212598,1337,5124,3.832460733,345,1006,1.915942029,243,530,1.181069959,588,1536,2.612244898,45,103,2.288888889
POA7052,783,1530,1.954022989,545,2217,2.067889908,293,990,2.37883959,838,3207,3.826968974,164,468,1.853658537,154,330,1.142857143,318,798,2.509433962,15,32,2.133333333
POA7053,397,768,1.934508816,309,1219,1.944983819,154,516,2.350649351,463,1735,3.747300216,56,145,1.589285714,52,116,1.230769231,108,261,2.416666667,11,21,1.909090909
POA7054,903,1753,1.941306755,844,3483,2.126777251,280,938,2.35,1124,4421,3.933274021,140,389,1.778571429,100,213,1.13,240,602,2.508333333,21,44,2.095238095
POA7055,48,92,1.916666667,42,164,1.904761905,8,28,2.5,50,192,3.84,16,42,1.625,8,25,2.125,24,67,2.791666667,0,4,#DIV/0!
POA7109,949,1872,1.97260274,694,2856,2.115273775,268,864,2.223880597,962,3720,3.866943867,195,552,1.830769231,138,286,1.072463768,333,838,2.516516517,20,43,2.15
POA7112,377,740,1.962864721,199,839,2.216080402,77,260,2.376623377,276,1099,3.981884058,84,240,1.857142857,49,106,1.163265306,133,346,2.601503759,9,17,1.888888889
POA7113,114,224,1.964912281,86,359,2.174418605,25,89,2.56,111,448,4.036036036,28,74,1.642857143,21,40,0.904761905,49,114,2.326530612,4,3,0.75
POA7116,326,633,1.941717791,206,844,2.097087379,58,187,2.224137931,264,1031,3.90530303,55,150,1.727272727,33,71,1.151515152,88,221,2.511363636,5,16,3.2
POA7117,126,235,1.865079365,43,160,1.720930233,17,58,2.411764706,60,218,3.633333333,15,40,1.666666667,7,16,1.285714286,22,56,2.545454545,4,8,2
POA7120,240,468,1.95,164,691,2.213414634,53,160,2.018867925,217,851,3.921658986,46,146,2.173913043,36,72,1,82,218,2.658536585,5,12,2.4
POA7140,1212,2385,1.967821782,864,3564,2.125,386,1247,2.230569948,1250,4811,3.8488,287,846,1.947735192,191,422,1.209424084,478,1268,2.652719665,35,74,2.114285714
POA7150,370,728,1.967567568,223,894,2.00896861,86,270,2.139534884,309,1164,3.766990291,45,122,1.711111111,27,59,1.185185185,72,181,2.513888889,8,18,2.25
POA7155,143,277,1.937062937,83,338,2.072289157,26,78,2,109,416,3.816513761,23,72,2.130434783,16,32,1,39,104,2.666666667,3,4,1.333333333
POA7162,112,225,2.008928571,46,185,2.02173913,23,65,1.826086957,69,250,3.623188406,10,28,1.8,9,20,1.222222222,19,48,2.526315789,0,3,#DIV/0!
POA7163,42,83,1.976190476,16,68,2.25,9,19,1.111111111,25,87,3.48,5,13,1.6,3,6,1,8,19,2.375,0,0,#DIV/0!
POA7170,532,1057,1.986842105,464,1871,2.032327586,256,849,2.31640625,720,2720,3.777777778,79,210,1.658227848,66,141,1.136363636,145,351,2.420689655,7,13,1.857142857
POA7171,356,699,1.963483146,238,915,1.844537815,106,349,2.29245283,344,1264,3.674418605,114,310,1.719298246,53,115,1.169811321,167,425,2.54491018,13,28,2.153846154
POA7172,385,756,1.963636364,227,947,2.171806167,126,418,2.317460317,353,1365,3.866855524,87,252,1.896551724,60,130,1.166666667,147,382,2.598639456,11,16,1.454545455
POA7173,699,1374,1.965665236,514,2053,1.994163424,184,578,2.141304348,698,2631,3.769340974,203,557,1.743842365,105,219,1.085714286,308,776,2.519480519,13,27,2.076923077
POA7176,45,93,2.066666667,36,140,1.888888889,16,53,2.3125,52,193,3.711538462,10,29,1.9,6,16,1.666666667,16,45,2.8125,0,3,#DIV/0!
POA7177,65,131,2.015384615,32,128,2,18,61,2.388888889,50,189,3.78,9,25,1.777777778,5,16,2.2,14,41,2.928571429,4,4,1
POA7178,50,109,2.18,27,106,1.925925926,9,26,1.888888889,36,132,3.666666667,7,17,1.428571429,8,18,1.25,15,35,2.333333333,0,0,#DIV/0!
POA7179,64,127,1.984375,20,65,1.25,6,16,1.666666667,26,81,3.115384615,0,8,#DIV/0!,5,7,0.4,5,15,3,6,4,0.666666667
POA7180,50,87,1.74,18,65,1.611111111,0,11,#DIV/0!,18,76,4.222222222,3,12,3,6,9,0.5,9,21,2.333333333,0,0,#DIV/0!
POA7182,40,77,1.925,11,49,2.454545455,9,18,1,20,67,3.35,3,3,0,3,7,1.333333333,6,10,1.666666667,0,0,#DIV/0!
POA7183,16,30,1.875,4,22,3.5,3,3,0,7,25,3.571428571,3,7,1.333333333,0,4,#DIV/0!,3,11,3.666666667,0,0,#DIV/0!
POA7184,104,202,1.942307692,58,214,1.689655172,10,31,2.1,68,245,3.602941176,16,44,1.75,10,16,0.6,26,60,2.307692308,5,12,2.4
POA7186,51,99,1.941176471,20,87,2.35,3,6,1,23,93,4.043478261,4,9,1.25,4,13,2.25,8,22,2.75,0,0,#DIV/0!
POA7190,482,949,1.968879668,172,701,2.075581395,73,211,1.890410959,245,912,3.72244898,54,154,1.851851852,39,77,0.974358974,93,231,2.483870968,5,9,1.8
POA7209,73,141,1.931506849,25,104,2.16,10,31,2.1,35,135,3.857142857,12,23,0.916666667,6,15,1.5,18,38,2.111111111,0,0,#DIV/0!
POA7210,144,274,1.902777778,62,232,1.741935484,26,78,2,88,310,3.522727273,26,80,2.076923077,20,41,1.05,46,121,2.630434783,3,6,2
POA7211,57,110,1.929824561,32,135,2.21875,17,66,2.882352941,49,201,4.102040816,4,18,3.5,12,29,1.416666667,16,47,2.9375,3,3,1
POA7212,236,458,1.940677966,161,671,2.167701863,60,202,2.366666667,221,873,3.950226244,31,68,1.193548387,28,65,1.321428571,59,133,2.254237288,4,4,1
POA7213,42,82,1.952380952,25,117,2.68,7,16,1.285714286,32,133,4.15625,5,10,1,6,16,1.666666667,11,26,2.363636364,0,0,#DIV/0!
POA7214,79,162,2.050632911,57,221,1.877192982,13,37,1.846153846,70,258,3.685714286,13,41,2.153846154,13,26,1,26,67,2.576923077,3,0,0
POA7215,508,996,1.960629921,209,800,1.827751196,74,222,2,283,1022,3.61130742,73,210,1.876712329,43,81,0.88372093,116,291,2.50862069,7,17,2.428571429
POA7216,521,1027,1.971209213,191,796,2.167539267,59,167,1.830508475,250,963,3.852,71,212,1.985915493,65,132,1.030769231,136,344,2.529411765,9,14,1.555555556
POA7248,1351,2690,1.991117691,959,4000,2.17101147,369,1246,2.376693767,1328,5246,3.950301205,562,1634,1.90747331,379,850,1.242744063,941,2484,2.639744952,97,201,2.072164948
POA7249,1316,2596,1.972644377,870,3415,1.925287356,335,1138,2.397014925,1205,4553,3.778423237,326,885,1.714723926,257,554,1.155642023,583,1439,2.468267581,66,138,2.090909091
POA7250,5020,9906,1.973306773,3565,14562,2.084712482,1615,5285,2.27244582,5180,19847,3.831467181,1299,3615,1.782909931,944,2076,1.199152542,2243,5691,2.537226928,176,365,2.073863636
POA7252,357,695,1.946778711,188,748,1.978723404,94,305,2.244680851,282,1053,3.734042553,34,87,1.558823529,30,63,1.1,64,150,2.34375,4,4,1
POA7253,571,1124,1.968476357,352,1484,2.215909091,160,510,2.1875,512,1994,3.89453125,204,646,2.166666667,105,212,1.019047619,309,858,2.776699029,18,38,2.111111111
POA7254,56,116,2.071428571,43,180,2.186046512,22,67,2.045454545,65,247,3.8,7,19,1.714285714,7,14,1,14,33,2.357142857,3,5,1.666666667
POA7255,129,240,1.860465116,48,162,1.375,14,35,1.5,62,197,3.177419355,5,15,2,7,14,1,12,29,2.416666667,0,9,#DIV/0!
POA7256,229,441,1.925764192,102,410,2.019607843,35,111,2.171428571,137,521,3.802919708,30,76,1.533333333,25,46,0.84,55,122,2.218181818,0,4,#DIV/0!
POA7257,4,12,3,0,5,#DIV/0!,0,0,#DIV/0!,0,5,#DIV/0!,6,10,0.666666667,0,3,#DIV/0!,6,13,2.166666667,5,4,0.8
POA7258,98,193,1.969387755,95,388,2.084210526,50,171,2.42,145,559,3.855172414,10,23,1.3,14,28,1,24,51,2.125,3,9,3
POA7259,53,104,1.962264151,30,137,2.566666667,26,79,2.038461538,56,216,3.857142857,11,33,2,3,3,0,14,36,2.571428571,0,0,#DIV/0!
POA7260,409,809,1.97799511,269,1139,2.234200743,89,286,2.213483146,358,1425,3.980446927,56,169,2.017857143,48,102,1.125,104,271,2.605769231,8,23,2.875
POA7261,33,71,2.151515152,13,50,1.846153846,0,7,#DIV/0!,13,57,4.384615385,4,14,2.5,8,13,0.625,12,27,2.25,0,0,#DIV/0!
POA7262,243,474,1.950617284,117,499,2.264957265,44,141,2.204545455,161,640,3.97515528,34,96,1.823529412,19,43,1.263157895,53,139,2.622641509,3,4,1.333333333
POA7263,93,184,1.978494624,59,246,2.169491525,25,73,1.92,84,319,3.797619048,18,53,1.944444444,22,51,1.318181818,40,104,2.6,0,3,#DIV/0!
POA7264,104,201,1.932692308,43,167,1.88372093,16,52,2.25,59,219,3.711864407,13,38,1.923076923,13,25,0.923076923,26,63,2.423076923,0,3,#DIV/0!
POA7265,34,59,1.735294118,23,90,1.913043478,5,19,2.8,28,109,3.892857143,12,31,1.583333333,3,9,2,15,40,2.666666667,0,0,#DIV/0!
POA7267,110,209,1.9,76,300,1.947368421,39,140,2.58974359,115,440,3.826086957,18,59,2.277777778,13,23,0.769230769,31,82,2.64516129,0,0,#DIV/0!
POA7268,130,263,2.023076923,86,339,1.941860465,46,157,2.413043478,132,496,3.757575758,19,65,2.421052632,19,39,1.052631579,38,104,2.736842105,5,4,0.8
POA7270,631,1239,1.963549921,255,1006,1.945098039,137,439,2.204379562,392,1445,3.68622449,101,290,1.871287129,73,156,1.136986301,174,446,2.563218391,8,22,2.75
POA7275,444,875,1.970720721,238,954,2.008403361,103,316,2.067961165,341,1270,3.724340176,58,167,1.879310345,43,93,1.162790698,101,260,2.574257426,10,22,2.2
POA7276,66,119,1.803030303,53,201,1.79245283,13,55,3.230769231,66,256,3.878787879,13,45,2.461538462,9,16,0.777777778,22,61,2.772727273,0,5,#DIV/0!
POA7277,624,1222,1.958333333,511,2132,2.17221135,200,667,2.335,711,2799,3.936708861,87,255,1.931034483,63,130,1.063492063,150,385,2.566666667,10,18,1.8
POA7290,244,488,2,211,868,2.113744076,61,202,2.31147541,272,1070,3.933823529,41,116,1.829268293,26,55,1.115384615,67,171,2.552238806,8,20,2.5
POA7291,98,190,1.93877551,70,284,2.057142857,36,114,2.166666667,106,398,3.754716981,13,43,2.307692308,16,31,0.9375,29,74,2.551724138,0,4,#DIV/0!
POA7292,86,174,2.023255814,71,296,2.169014085,17,55,2.235294118,88,351,3.988636364,6,17,1.833333333,6,12,1,12,29,2.416666667,4,3,0.75
POA7300,351,699,1.991452991,270,1105,2.092592593,132,434,2.287878788,402,1539,3.828358209,66,178,1.696969697,35,84,1.4,101,262,2.594059406,7,14,2
POA7301,545,1072,1.966972477,306,1253,2.094771242,142,464,2.267605634,448,1717,3.832589286,101,290,1.871287129,58,128,1.206896552,159,418,2.628930818,6,18,3
POA7302,213,419,1.96713615,150,641,2.273333333,61,209,2.426229508,211,850,4.028436019,35,104,1.971428571,24,58,1.416666667,59,162,2.745762712,9,20,2.222222222
POA7303,326,640,1.963190184,209,810,1.875598086,74,234,2.162162162,283,1044,3.689045936,45,126,1.8,28,62,1.214285714,73,188,2.575342466,9,22,2.444444444
POA7304,776,1521,1.960051546,440,1872,2.254545455,181,570,2.149171271,621,2442,3.93236715,124,363,1.927419355,90,190,1.111111111,214,553,2.58411215,19,38,2
POA7305,172,343,1.994186047,88,366,2.159090909,43,139,2.23255814,131,505,3.854961832,33,100,2.03030303,25,61,1.44,58,161,2.775862069,8,5,0.625
POA7306,503,975,1.938369781,287,1204,2.195121951,160,522,2.2625,447,1726,3.861297539,82,247,2.012195122,59,119,1.016949153,141,366,2.595744681,8,16,2
POA7307,1242,2432,1.958132045,691,2775,2.015918958,316,1024,2.240506329,1007,3799,3.772591857,214,612,1.859813084,147,322,1.19047619,361,934,2.587257618,26,57,2.192307692
POA7310,3116,6146,1.972400513,2009,8191,2.077152812,811,2602,2.20838471,2820,10793,3.827304965,891,2553,1.865319865,562,1203,1.140569395,1453,3756,2.584996559,86,174,2.023255814
POA7315,1770,3462,1.955932203,1012,4150,2.100790514,484,1561,2.225206612,1496,5711,3.817513369,377,1076,1.854111406,275,586,1.130909091,652,1662,2.549079755,30,65,2.166666667
POA7316,755,1490,1.973509934,490,1996,2.073469388,224,691,2.084821429,714,2687,3.763305322,131,373,1.847328244,79,164,1.075949367,210,537,2.557142857,17,39,2.294117647
POA7320,1837,3626,1.973870441,1213,4936,2.069249794,459,1462,2.185185185,1672,6398,3.826555024,586,1680,1.866894198,351,766,1.182336182,937,2446,2.610458911,54,109,2.018518519
POA7321,589,1160,1.969439728,402,1645,2.092039801,178,571,2.207865169,580,2216,3.820689655,77,220,1.857142857,53,109,1.056603774,130,329,2.530769231,12,25,2.083333333
POA7322,472,937,1.985169492,281,1129,2.017793594,126,418,2.317460317,407,1547,3.800982801,133,365,1.744360902,70,146,1.085714286,203,511,2.517241379,14,24,1.714285714
POA7325,1116,2197,1.968637993,649,2658,2.095531587,291,936,2.216494845,940,3594,3.823404255,209,625,1.990430622,147,321,1.183673469,356,946,2.657303371,23,46,2
POA7330,764,1517,1.985602094,644,2708,2.204968944,183,566,2.092896175,827,3274,3.958887545,156,444,1.846153846,87,178,1.045977011,243,622,2.559670782,14,29,2.071428571
POA7331,51,107,2.098039216,39,154,1.948717949,11,33,2,50,187,3.74,9,30,2.333333333,4,9,1.25,13,39,3,0,0,#DIV/0!
POA7467,215,428,1.990697674,159,625,1.93081761,39,121,2.102564103,198,746,3.767676768,62,170,1.741935484,32,63,0.96875,94,233,2.478723404,3,4,1.333333333
POA7468,80,168,2.1,51,187,1.666666667,15,44,1.933333333,66,231,3.5,12,26,1.166666667,7,15,1.142857143,19,41,2.157894737,0,0,#DIV/0!
POA7469,98,193,1.969387755,77,310,2.025974026,37,107,1.891891892,114,417,3.657894737,17,54,2.176470588,13,28,1.153846154,30,82,2.733333333,0,0,#DIV/0!
POA7470,108,214,1.981481481,76,311,2.092105263,12,35,1.916666667,88,346,3.931818182,28,79,1.821428571,19,37,0.947368421,47,116,2.468085106,4,5,1.25
POA9191,4,5,1.25,0,0,#DIV/0!,0,0,#DIV/0!,0,0,#DIV/0!,0,0,#DIV/0!,0,3,#DIV/0!,0,3,#DIV/0!,0,0,#DIV/0!
POA0800,551,1058,1.920145191,165,558,1.381818182,42,125,1.976190476,207,683,3.299516908,32,79,1.46875,38,85,1.236842105,70,164,2.342857143,20,53,2.65
POA0810,2623,5147,1.962256958,2409,9623,1.99460357,855,2764,2.232748538,3264,12387,3.795036765,665,1956,1.941353383,536,1174,1.190298507,1201,3130,2.606161532,135,290,2.148148148
POA0812,1506,2977,1.976759628,1625,6774,2.168615385,656,2175,2.31554878,2281,8949,3.923279263,546,1728,2.164835165,396,875,1.20959596,942,2603,2.763269639,83,175,2.108433735
POA0820,2029,3911,1.927550517,1280,4917,1.84140625,403,1248,2.096774194,1683,6165,3.663101604,279,765,1.741935484,209,464,1.220095694,488,1229,2.518442623,88,197,2.238636364
POA0822,1146,2425,2.116055846,2186,11290,3.164684355,364,1361,2.739010989,2550,12651,4.961176471,942,3872,3.110403397,331,985,1.975830816,1273,4857,3.815396701,103,302,2.932038835
POA0828,84,167,1.988095238,47,221,2.70212766,34,111,2.264705882,81,332,4.098765432,20,54,1.7,11,26,1.363636364,31,80,2.580645161,5,5,1
POA0829,30,64,2.133333333,18,77,2.277777778,3,9,2,21,86,4.095238095,3,8,1.666666667,6,4,-0.333333333,9,12,1.333333333,5,10,2
POA0830,1329,2586,1.945823928,1760,7018,1.9875,431,1418,2.290023202,2191,8436,3.850296668,608,1829,2.008223684,285,634,1.224561404,893,2463,2.758118701,62,129,2.080645161
POA0832,831,1616,1.944645006,1108,4414,1.983754513,177,580,2.276836158,1285,4994,3.886381323,261,717,1.747126437,107,229,1.140186916,368,946,2.570652174,34,69,2.029411765
POA0835,509,1003,1.970530452,424,1717,2.049528302,205,644,2.141463415,629,2361,3.753577107,76,200,1.631578947,68,153,1.25,144,353,2.451388889,11,23,2.090909091
POA0836,680,1316,1.935294118,685,2769,2.042335766,211,660,2.127962085,896,3429,3.827008929,163,460,1.82208589,89,198,1.224719101,252,658,2.611111111,18,45,2.5
POA0837,38,77,2.026315789,41,154,1.756097561,10,41,3.1,51,195,3.823529412,13,42,2.230769231,7,13,0.857142857,20,55,2.75,0,0,#DIV/0!
POA0838,69,133,1.927536232,55,204,1.709090909,18,51,1.833333333,73,255,3.493150685,18,50,1.777777778,5,11,1.2,23,61,2.652173913,3,9,3
POA0840,75,141,1.88,22,84,1.818181818,3,15,4,25,99,3.96,6,19,2.166666667,4,11,1.75,10,30,3,3,14,4.666666667
POA0841,68,124,1.823529412,46,196,2.260869565,10,37,2.7,56,233,4.160714286,16,38,1.375,8,16,1,24,54,2.25,0,3,#DIV/0!
POA0845,22,50,2.272727273,10,28,0.8,0,9,#DIV/0!,10,37,3.7,17,39,1.294117647,3,12,3,20,51,2.55,0,0,#DIV/0!
POA0846,25,49,1.96,21,78,1.714285714,3,10,2.333333333,24,88,3.666666667,4,22,4.5,3,3,0,7,25,3.571428571,5,7,1.4
POA0847,27,59,2.185185185,22,123,3.590909091,4,11,1.75,26,134,5.153846154,11,37,2.363636364,4,3,-0.25,15,40,2.666666667,0,3,#DIV/0!
POA0850,662,1305,1.971299094,621,2548,2.103059581,127,398,2.133858268,748,2946,3.938502674,241,745,2.091286307,91,203,1.230769231,332,948,2.855421687,23,57,2.47826087
POA0852,408,852,2.088235294,751,3807,3.069241012,74,266,2.594594595,825,4073,4.936969697,273,1148,3.205128205,59,157,1.661016949,332,1305,3.930722892,32,82,2.5625
POA0853,37,64,1.72972973,102,400,1.921568627,9,21,1.333333333,111,421,3.792792793,0,6,#DIV/0!,0,0,#DIV/0!,0,6,#DIV/0!,0,0,#DIV/0!
POA0854,47,83,1.765957447,82,454,3.536585366,6,27,3.5,88,481,5.465909091,40,145,2.625,8,26,2.25,48,171,3.5625,6,25,4.166666667
POA0860,231,477,2.064935065,205,945,2.609756098,37,118,2.189189189,242,1063,4.392561983,118,433,2.669491525,42,97,1.30952381,160,530,3.3125,17,36,2.117647059
POA0862,40,85,2.125,50,247,2.94,5,13,1.6,55,260,4.727272727,16,64,3,5,18,2.6,21,82,3.904761905,5,23,4.6
POA0870,2117,4129,1.950401512,2075,8387,2.041927711,580,1865,2.215517241,2655,10252,3.861393597,689,2104,2.053701016,335,764,1.280597015,1024,2868,2.80078125,120,273,2.275
POA0872,755,1627,2.154966887,1253,6017,2.80207502,150,593,2.953333333,1403,6610,4.711332858,613,2361,2.851549755,198,601,2.035353535,811,2962,3.652281134,80,220,2.75
POA0880,335,662,1.976119403,665,2888,2.342857143,104,346,2.326923077,769,3234,4.205461638,163,618,2.791411043,59,202,2.423728814,222,820,3.693693694,8,24,3
POA0885,71,140,1.971830986,111,434,1.90990991,16,50,2.125,127,484,3.811023622,6,12,1,5,10,1,11,22,2,3,6,2
POA0886,98,193,1.969387755,103,416,2.038834951,19,52,1.736842105,122,468,3.836065574,14,44,2.142857143,12,29,1.416666667,26,73,2.807692308,6,10,1.666666667
POA2600,890,1739,1.953932584,488,1942,1.979508197,236,770,2.262711864,724,2712,3.745856354,79,226,1.860759494,112,238,1.125,191,464,2.429319372,20,40,2
POA2601,283,540,1.908127208,29,94,1.24137931,9,33,2.666666667,38,127,3.342105263,4,14,2.5,13,25,0.923076923,17,39,2.294117647,9,16,1.777777778
POA2602,2932,5723,1.951909959,2119,8179,1.859839547,734,2411,2.284741144,2853,10590,3.711882229,479,1240,1.588726514,572,1232,1.153846154,1051,2472,2.352045671,137,283,2.065693431
POA2603,912,1790,1.962719298,625,2521,2.0336,360,1171,2.252777778,985,3692,3.74822335,105,277,1.638095238,126,283,1.246031746,231,560,2.424242424,31,66,2.129032258
POA2604,940,1821,1.937234043,547,2122,1.879341865,185,592,2.2,732,2714,3.707650273,167,451,1.700598802,186,400,1.150537634,353,851,2.410764873,44,88,2
POA2605,1140,2238,1.963157895,988,3920,1.967611336,399,1310,2.28320802,1387,5230,3.77072819,157,457,1.910828025,203,433,1.133004926,360,890,2.472222222,38,76,2
POA2606,925,1822,1.96972973,601,2374,1.950083195,210,720,2.428571429,811,3094,3.815043157,128,350,1.734375,168,384,1.285714286,296,734,2.47972973,42,86,2.047619048
POA2607,1554,3061,1.96975547,1091,4414,2.045829514,580,1951,2.363793103,1671,6365,3.809096349,203,542,1.669950739,261,578,1.214559387,464,1120,2.413793103,48,98,2.041666667
POA2609,91,176,1.934065934,35,128,1.657142857,18,61,2.388888889,53,189,3.566037736,15,32,1.133333333,16,33,1.0625,31,65,2.096774194,5,5,1
POA2611,2520,4982,1.976984127,2043,8172,2,897,2944,2.282051282,2940,11116,3.780952381,437,1182,1.704805492,481,1082,1.249480249,918,2264,2.466230937,82,165,2.012195122
POA2612,1541,2983,1.935756003,604,2282,1.778145695,249,816,2.277108434,853,3098,3.631887456,152,361,1.375,150,320,1.133333333,302,681,2.254966887,78,164,2.102564103
POA2614,2078,4095,1.970644851,1562,6248,2,627,2081,2.318979266,2189,8329,3.80493376,333,878,1.636636637,367,804,1.190735695,700,1682,2.402857143,76,165,2.171052632
POA2615,4340,8587,1.978571429,4009,16174,2.034422549,1634,5489,2.359241126,5643,21663,3.83891547,1051,3012,1.865842055,907,2024,1.231532525,1958,5036,2.572012257,170,353,2.076470588
POA2617,3035,5997,1.975947282,2112,8351,1.95407197,1085,3632,2.347465438,3197,11983,3.748201439,448,1183,1.640625,496,1115,1.247983871,944,2298,2.434322034,159,338,2.125786164
POA2900,217,422,1.944700461,75,272,1.626666667,26,79,2.038461538,101,351,3.475247525,43,114,1.651162791,41,94,1.292682927,84,208,2.476190476,7,20,2.857142857
POA2902,1600,3154,1.97125,1255,5093,2.058167331,735,2448,2.330612245,1990,7541,3.789447236,393,1091,1.776081425,344,776,1.255813953,737,1867,2.533242877,72,154,2.138888889
POA2903,931,1853,1.990332975,800,3251,2.06375,461,1602,2.47505423,1261,4853,3.84853291,232,670,1.887931034,250,559,1.236,482,1229,2.549792531,37,75,2.027027027
POA2904,1296,2553,1.969907407,1068,4362,2.084269663,812,2762,2.401477833,1880,7124,3.789361702,224,639,1.852678571,324,748,1.308641975,548,1387,2.531021898,44,90,2.045454545
POA2905,2342,4658,1.988898377,2705,10981,2.059519409,1421,4932,2.470795215,4126,15913,3.856761997,828,2460,1.971014493,727,1661,1.284731774,1555,4121,2.650160772,116,246,2.120689655
POA2906,1412,2816,1.994334278,1899,7765,2.088994207,804,2768,2.44278607,2703,10533,3.896781354,448,1267,1.828125,353,796,1.254957507,801,2063,2.575530587,52,111,2.134615385
POA2911,92,169,1.836956522,64,209,1.265625,6,21,2.5,70,230,3.285714286,12,24,1,6,14,1.333333333,18,38,2.111111111,0,8,#DIV/0!
POA2912,618,1230,1.990291262,776,2988,1.850515464,189,638,2.375661376,965,3626,3.757512953,134,350,1.611940299,83,195,1.34939759,217,545,2.511520737,36,81,2.25
POA2913,2308,4607,1.99610052,2768,11051,1.992413295,896,3060,2.415178571,3664,14111,3.851255459,511,1397,1.733855186,387,895,1.312661499,898,2292,2.55233853,109,234,2.146788991
POA2914,1099,2159,1.964513194,1937,7633,1.94062984,342,1153,2.371345029,2279,8786,3.855199649,267,724,1.711610487,159,382,1.402515723,426,1106,2.596244131,37,74,2
POA6798,133,258,1.939849624,115,453,1.939130435,52,183,2.519230769,167,636,3.808383234,24,53,1.208333333,10,26,1.6,34,79,2.323529412,5,17,3.4
POA6799,65,130,2,78,298,1.820512821,24,56,1.333333333,102,354,3.470588235,0,7,,4,4,0,4,11,2.75,0,4,#DIV/0!
POA9494,0,0,,0,0,,0,0,,0,0,,0,0,,0,0,,0,0,,0,0,#DIV/0!
POA9797,0,0,,0,0,,0,0,,0,0,,0,0,,0,0,,0,0,,3,0,0